 NR.;DESCRIZIONE COMUNE;SIGLA;NOTE;POPOLAZIONE CENSITA UOMINI;POPOLAZIONE CENSITA DONNE;POPOLAZIONE CENSITA TOTALE
1;ABANO TERME;PD;;9556;10567;20123
2;ABBADIA CERRETO;LO;;139;136;275
3;ABBADIA LARIANA;LC;;1565;1637;3202
4;ABBADIA SAN SALVATORE;SI;;2893;3130;6023
5;ABBASANTA;OR;;1267;1327;2594
6;ABBATEGGIO;PE;;186;177;363
7;ABBIATEGRASSO;MI;;15799;16584;32383
8;ABETONE CUTIGLIANO;PT;;941;961;1902
9;ABRIOLA;PZ;;639;678;1317
10;ACATE;RG;;5786;4795;10581
11;ACCADIA;FG;;1046;1136;2182
12;ACCEGLIO;CN;;78;79;157
13;ACCETTURA;MT;;813;835;1648
14;ACCIANO;AQ;;152;130;282
15;ACCUMOLI;RI;;285;262;547
16;ACERENZA;PZ;;1057;1073;2130
17;ACERNO;SA;;1270;1230;2500
18;ACERRA;NA;;28850;29644;58494
19;ACI BONACCORSI;CT;;1696;1829;3525
20;ACI CASTELLO;CT;;8605;9370;17975
21;ACI CATENA;CT;;13842;14282;28124
22;ACI SANT'ANTONIO;CT;;8986;9072;18058
23;ACIREALE;CT;;24653;26082;50735
24;ACQUAFONDATA;FR;;147;129;276
25;ACQUAFORMOSA;CS;;499;502;1001
26;ACQUAFREDDA;BS;;729;789;1518
27;ACQUALAGNA;PU;;2075;2107;4182
28;ACQUANEGRA CREMONESE;CR;;538;585;1123
29;ACQUANEGRA SUL CHIESE;MN;;1348;1388;2736
30;ACQUAPENDENTE;VT;;2594;2710;5304
31;ACQUAPPESA;CS;;862;881;1743
32;ACQUARO;VV;;912;979;1891
33;ACQUASANTA TERME;AP;;1272;1259;2531
34;ACQUASPARTA;TR;;2141;2295;4436
35;ACQUAVIVA COLLECROCE;CB;;295;290;585
36;ACQUAVIVA D'ISERNIA;IS;;194;183;377
37;ACQUAVIVA DELLE FONTI;BA;;9739;10348;20087
38;ACQUAVIVA PICENA;AP;;1802;1890;3692
39;ACQUAVIVA PLATANI;CL;;440;451;891
40;ACQUEDOLCI;ME;;2669;2825;5494
41;ACQUI TERME;AL;;8916;10127;19043
42;ACRI;CS;;9253;9874;19127
43;ACUTO;FR;;926;949;1875
44;ADELFIA;BA;;8116;8438;16554
45;ADRANO;CT;;16483;17627;34110
46;ADRARA SAN MARTINO;BG;;1145;1027;2172
47;ADRARA SAN ROCCO;BG;;426;381;807
48;ADRIA;RO;;9125;9656;18781
49;ADRO;BS;;3575;3596;7171
50;AFFI;VR;;1178;1209;2387
51;AFFILE;RM;;725;708;1433
52;AFRAGOLA;NA;;30718;31480;62198
53;AFRICO;RC;;1397;1386;2783
54;AGAZZANO;PC;;964;1011;1975
55;AGEROLA;NA;;3789;3877;7666
56;AGGIUS;SS;;675;730;1405
57;AGIRA;EN;;3807;3919;7726
58;AGLIANA;PT;;8857;9093;17950
59;AGLIANO TERME;AT;;771;755;1526
60;AGLIE';TO;;1215;1347;2562
61;AGLIENTU;SS;;584;584;1168
62;AGNA;PD;;1557;1595;3152
63;AGNADELLO;CR;;1948;1894;3842
64;AGNANA CALABRA;RC;;240;226;466
65;AGNONE;IS;;2342;2361;4703
66;AGNOSINE;BS;;832;790;1622
67;AGORDO;BL;;1933;2152;4085
68;AGOSTA;RM;;837;867;1704
69;AGRA;VA;;204;203;407
70;AGRATE BRIANZA;MB;;7631;7874;15505
71;AGRATE CONTURBIA;NO;;783;737;1520
72;AGRIGENTO;AG;;27337;28512;55849
73;AGROPOLI;SA;;10448;10725;21173
74;AGUGLIANO;AN;;2308;2374;4682
75;AGUGLIARO;VI;;712;702;1414
76;AICURZIO;MB;;1028;1043;2071
77;AIDOMAGGIORE;OR;;180;218;398
78;AIDONE;EN;;2127;2157;4284
79;AIELLI;AQ;;717;706;1423
80;AIELLO CALABRO;CS;;709;726;1435
81;AIELLO DEL FRIULI;UD;;1042;1132;2174
82;AIELLO DEL SABATO;AV;;1997;2010;4007
83;AIETA;CS;;373;392;765
84;AILANO;CE;;558;667;1225
85;AILOCHE;BI;;147;167;314
86;AIRASCA;TO;;1867;1793;3660
87;AIROLA;BN;;4032;4102;8134
88;AIROLE;IM;;191;172;363
89;AIRUNO;LC;;1463;1369;2832
90;AISONE;CN;;103;102;205
91;ALA;TN;;4427;4374;8801
92;ALA DI STURA;TO;;242;225;467
93;ALA' DEI SARDI;SS;;895;894;1789
94;ALAGNA;PV;;394;405;799
95;ALAGNA VALSESIA;VC;;378;352;730
96;ALANNO;PE;;1628;1762;3390
97;ALASSIO;SV;;4705;5463;10168
98;ALATRI;FR;;13642;14218;27860
99;ALBA;CN;;14746;16349;31095
100;ALBA ADRIATICA;TE;;6117;6624;12741
101;ALBAGIARA;OR;;122;124;246
102;ALBAIRATE;MI;;2324;2389;4713
103;ALBANELLA;SA;;3126;3147;6273
104;ALBANO DI LUCANIA;PZ;;697;665;1362
105;ALBANO LAZIALE;RM;;19093;20581;39674
106;ALBANO SANT'ALESSANDRO;BG;;4164;4110;8274
107;ALBANO VERCELLESE;VC;;153;157;310
108;ALBAREDO D'ADIGE;VR;;2659;2613;5272
109;ALBAREDO PER SAN MARCO;SO;;155;136;291
110;ALBARETO;PR;;1016;1056;2072
111;ALBARETTO DELLA TORRE;CN;;113;108;221
112;ALBAVILLA;CO;;3124;3236;6360
113;ALBENGA;SV;;11441;11994;23435
114;ALBERA LIGURE;AL;;170;144;314
115;ALBEROBELLO;BA;;5003;5328;10331
116;ALBERONA;FG;;410;439;849
117;ALBESE CON CASSANO;CO;;2062;2127;4189
118;ALBETTONE;VI;;1004;978;1982
119;ALBI;CZ;;424;406;830
120;ALBIANO;TN;;772;722;1494
121;ALBIANO D'IVREA;TO;;785;852;1637
122;ALBIATE;MB;;3210;3364;6574
123;ALBIDONA;CS;;583;601;1184
124;ALBIGNASEGO;PD;;12921;13721;26642
125;ALBINEA;RE;;4291;4497;8788
126;ALBINO;BG;;8625;8867;17492
127;ALBIOLO;CO;;1360;1365;2725
128;ALBISOLA SUPERIORE;SV;;4503;5141;9644
129;ALBISSOLA MARINA;SV;;2502;2757;5259
130;ALBIZZATE;VA;;2544;2651;5195
131;ALBONESE;PV;;259;274;533
132;ALBOSAGGIA;SO;;1510;1501;3011
133;ALBUGNANO;AT;;244;254;498
134;ALBUZZANO;PV;;1781;1793;3574
135;ALCAMO;TP;;22053;22666;44719
136;ALCARA LI FUSI;ME;;829;913;1742
137;ALDENO;TN;;1564;1624;3188
138;ALDINO/ALDEIN;BZ;;838;793;1631
139;ALES;OR;;658;635;1293
140;ALESSANDRIA;AL;;44072;46753;90825
141;ALESSANDRIA DEL CARRETTO;CS;;198;164;362
142;ALESSANDRIA DELLA ROCCA;AG;;1226;1295;2521
143;ALESSANO;LE;;2919;3161;6080
144;ALEZIO;LE;;2681;2948;5629
145;ALFANO;SA;;460;504;964
146;ALFEDENA;AQ;;528;397;925
147;ALFIANELLO;BS;;1196;1176;2372
148;ALFIANO NATTA;AL;;365;362;727
149;ALFONSINE;RA;;5619;5887;11506
150;ALGHERO;SS;;20419;22039;42458
151;ALGUA;BG;;332;324;656
152;ALI';ME;;336;349;685
153;ALI' TERME;ME;;1152;1217;2369
154;ALIA;PA;;1614;1753;3367
155;ALIANO;MT;;446;447;893
156;ALICE BEL COLLE;AL;;384;329;713
157;ALICE CASTELLO;VC;;1260;1243;2503
158;ALIFE;CE;;3675;3715;7390
159;ALIMENA;PA;;842;931;1773
160;ALIMINUSA;PA;;562;527;1089
161;ALLAI;OR;;182;176;358
162;ALLEGHE;BL;;538;572;1110
163;ALLEIN;AO;;103;108;211
164;ALLERONA;TR;;822;863;1685
165;ALLISTE;LE;;3106;3375;6481
166;ALLUMIERE;RM;;1875;1903;3778
167;ALLUVIONI PIOVERA;AL;;795;821;1616
168;ALME';BG;;2669;2838;5507
169;ALMENNO SAN BARTOLOMEO;BG;;3253;3251;6504
170;ALMENNO SAN SALVATORE;BG;;2713;2823;5536
171;ALMESE;TO;;3099;3232;6331
172;ALONTE;VI;;811;782;1593
173;ALPAGO;BL;;3313;3304;6617
174;ALPETTE;TO;;127;113;240
175;ALPIGNANO;TO;;8155;8346;16501
176;ALSENO;PC;;2293;2379;4672
177;ALSERIO;CO;;653;650;1303
178;ALTA VAL TIDONE;PC;;1474;1432;2906
179;ALTA VALLE INTELVI;CO;;1527;1495;3022
180;ALTAMURA;BA;;34323;35532;69855
181;ALTARE;SV;;967;965;1932
182;ALTAVALLE;TN;;813;816;1629
183;ALTAVILLA IRPINA;AV;;1979;2025;4004
184;ALTAVILLA MILICIA;PA;;4260;4240;8500
185;ALTAVILLA MONFERRATO;AL;;216;183;399
186;ALTAVILLA SILENTINA;SA;;3444;3518;6962
187;ALTAVILLA VICENTINA;VI;;5869;5951;11820
188;ALTIDONA;FM;;1715;1792;3507
189;ALTILIA;CS;;366;307;673
190;ALTINO;CH;;1506;1569;3075
191;ALTISSIMO;VI;;1121;1031;2152
192;ALTIVOLE;TV;;3475;3540;7015
193;ALTO;CN;;76;66;142
194;ALTO RENO TERME;BO;;3354;3533;6887
195;ALTO SERMENZA;VC;;82;63;145
196;ALTOFONTE;PA;;4807;5096;9903
197;ALTOMONTE;CS;;2008;2066;4074
198;ALTOPASCIO;LU;;7787;7939;15726
199;ALTOPIANO DELLA VIGOLANA;TN;;2570;2570;5140
200;ALVIANO;TR;;670;726;1396
201;ALVIGNANO;CE;;2231;2333;4564
202;ALVITO;FR;;1249;1262;2511
203;ALZANO LOMBARDO;BG;;6579;6845;13424
204;ALZANO SCRIVIA;AL;;184;164;348
205;ALZATE BRIANZA;CO;;2398;2444;4842
206;AMALFI;SA;;2347;2483;4830
207;AMANDOLA;FM;;1646;1657;3303
208;AMANTEA;CS;;6800;7089;13889
209;AMARO;UD;;418;426;844
210;AMARONI;CZ;;814;866;1680
211;AMASENO;FR;;2061;2034;4095
212;AMATO;CZ;;384;403;787
213;AMATRICE;RI;;1217;1076;2293
214;AMBIVERE;BG;;1218;1148;2366
215;AMBLAR-DON;TN;;274;273;547
216;AMEGLIA;SP;;2122;2196;4318
217;AMELIA;TR;;5695;5912;11607
218;AMENDOLARA;CS;;1368;1392;2760
219;AMENO;NO;;431;419;850
220;AMOROSI;BN;;1312;1329;2641
221;AMPEZZO;UD;;459;461;920
222;ANACAPRI;NA;;3386;3496;6882
223;ANAGNI;FR;;10199;10593;20792
224;ANCARANO;TE;;909;902;1811
225;ANCONA;AN;;47673;50729;98402
226;ANDALI;CZ;;324;338;662
227;ANDALO;TN;;562;583;1145
228;ANDALO VALTELLINO;SO;;306;291;597
229;ANDEZENO;TO;;1018;1018;2036
230;ANDORA;SV;;3485;3776;7261
231;ANDORNO MICCA;BI;;1461;1582;3043
232;ANDRANO;LE;;2215;2394;4609
233;ANDRATE;TO;;260;214;474
234;ANDREIS;PN;;125;121;246
235;ANDRETTA;AV;;817;871;1688
236;ANDRIA;BT;;48180;49408;97588
237;ANDRIANO/ANDRIAN;BZ;;517;495;1012
238;ANELA;SS;;293;295;588
239;ANFO;BS;;237;213;450
240;ANGERA;VA;;2568;2828;5396
241;ANGHIARI;AR;;2628;2757;5385
242;ANGIARI;VR;;1218;1230;2448
243;ANGOLO TERME;BS;;1167;1142;2309
244;ANGRI;SA;;16613;17350;33963
245;ANGROGNA;TO;;433;394;827
246;ANGUILLARA SABAZIA;RM;;9396;9771;19167
247;ANGUILLARA VENETA;PD;;2037;2119;4156
248;ANNICCO;CR;;1006;977;1983
249;ANNONE DI BRIANZA;LC;;1133;1152;2285
250;ANNONE VENETO;VE;;1925;1889;3814
251;ANOIA;RC;;966;1082;2048
252;ANTEGNATE;BG;;1634;1593;3227
253;ANTERIVO/ALTREI;BZ;;201;198;399
254;ANTEY-SAINT-ANDRE';AO;;266;276;542
255;ANTICOLI CORRADO;RM;;416;421;837
256;ANTIGNANO;AT;;475;474;949
257;ANTILLO;ME;;426;414;840
258;ANTONIMINA;RC;;600;591;1191
259;ANTRODOCO;RI;;1197;1159;2356
260;ANTRONA SCHIERANCO;VB;;198;202;400
261;ANVERSA DEGLI ABRUZZI;AQ;;154;149;303
262;ANZANO DEL PARCO;CO;;872;883;1755
263;ANZANO DI PUGLIA;FG;;532;571;1103
264;ANZI;PZ;;751;802;1553
265;ANZIO;RM;;29499;29094;58593
266;ANZOLA D'OSSOLA;VB;;194;187;381
267;ANZOLA DELL'EMILIA;BO;;6077;6236;12313
268;AOSTA;AO;;15615;17608;33223
269;APECCHIO;PU;;857;878;1735
270;APICE;BN;;2652;2697;5349
271;APIRO;MC;;999;1051;2050
272;APOLLOSA;BN;;1246;1239;2485
273;APPIANO GENTILE;CO;;3743;3942;7685
274;APPIANO SULLA STRADA DEL VINO/EPPAN AN DER WEINSTRASSE;BZ;;7281;7460;14741
275;APPIGNANO;MC;;1944;2086;4030
276;APPIGNANO DEL TRONTO;AP;;823;870;1693
277;APRICA;SO;;738;757;1495
278;APRICALE;IM;;325;303;628
279;APRICENA;FG;;6247;6370;12617
280;APRIGLIANO;CS;;1171;1213;2384
281;APRILIA;LT;;36782;37337;74119
282;AQUARA;SA;;673;689;1362
283;AQUILA D'ARROSCIA;IM;;78;69;147
284;AQUILEIA;UD;;1541;1607;3148
285;AQUILONIA;AV;;782;725;1507
286;AQUINO;FR;;2460;2539;4999
287;ARADEO;LE;;4267;4661;8928
288;ARAGONA;AG;;4299;4561;8860
289;ARAMENGO;AT;;289;276;565
290;ARBA;PN;;648;626;1274
291;ARBOREA;OR;;1885;1892;3777
292;ARBORIO;VC;;442;388;830
293;ARBUS;SU;;2872;2971;5843
294;ARCADE;TV;;2273;2231;4504
295;ARCE;FR;;2667;2763;5430
296;ARCENE;BG;;2427;2388;4815
297;ARCEVIA;AN;;2134;2152;4286
298;ARCHI;CH;;998;1034;2032
299;ARCIDOSSO;GR;;2103;2123;4226
300;ARCINAZZO ROMANO;RM;;615;621;1236
301;ARCISATE;VA;;4849;5066;9915
302;ARCO;TN;;8634;9057;17691
303;ARCOLA;SP;;4955;5228;10183
304;ARCOLE;VR;;3157;3172;6329
305;ARCONATE;MI;;3325;3433;6758
306;ARCORE;MB;;8653;9175;17828
307;ARCUGNANO;VI;;3886;3831;7717
308;ARDARA;SS;;376;360;736
309;ARDAULI;OR;;367;413;780
310;ARDEA;RM;;24821;24043;48864
311;ARDENNO;SO;;1630;1592;3222
312;ARDESIO;BG;;1695;1649;3344
313;ARDORE;RC;;2338;2442;4780
314;ARENA;VV;;607;646;1253
315;ARENA PO;PV;;770;752;1522
316;ARENZANO;GE;;5291;5872;11163
317;ARESE;MI;;9413;10138;19551
318;AREZZO;AR;;46733;49984;96717
319;ARGEGNO;CO;;331;348;679
320;ARGELATO;BO;;4760;4933;9693
321;ARGENTA;FE;;10266;10729;20995
322;ARGENTERA;CN;;38;40;78
323;ARGUELLO;CN;;104;95;199
324;ARGUSTO;CZ;;220;238;458
325;ARI;CH;;546;522;1068
326;ARIANO IRPINO;AV;;10378;10862;21240
327;ARIANO NEL POLESINE;RO;;1934;2066;4000
328;ARICCIA;RM;;8735;9382;18117
329;ARIELLI;CH;;518;563;1081
330;ARIENZO;CE;;2598;2692;5290
331;ARIGNANO;TO;;569;503;1072
332;ARITZO;NU;;645;592;1237
333;ARIZZANO;VB;;931;1010;1941
334;ARLENA DI CASTRO;VT;;425;402;827
335;ARLUNO;MI;;6091;6184;12275
336;ARMENO;NO;;1003;1107;2110
337;ARMENTO;PZ;;280;299;579
338;ARMO;IM;;61;57;118
339;ARMUNGIA;SU;;219;209;428
340;ARNAD;AO;;591;658;1249
341;ARNARA;FR;;1058;1141;2199
342;ARNASCO;SV;;292;281;573
343;ARNESANO;LE;;1967;1979;3946
344;AROLA;VB;;123;118;241
345;ARONA;NO;;6414;7261;13675
346;AROSIO;CO;;2497;2617;5114
347;ARPAIA;BN;;988;993;1981
348;ARPAISE;BN;;361;366;727
349;ARPINO;FR;;3310;3489;6799
350;ARQUA' PETRARCA;PD;;903;914;1817
351;ARQUA' POLESINE;RO;;1296;1320;2616
352;ARQUATA DEL TRONTO;AP;;513;500;1013
353;ARQUATA SCRIVIA;AL;;3027;3209;6236
354;ARRE;PD;;1059;1038;2097
355;ARRONE;TR;;1240;1321;2561
356;ARSAGO SEPRIO;VA;;2376;2409;4785
357;ARSIE';BL;;1086;1117;2203
358;ARSIERO;VI;;1536;1485;3021
359;ARSITA;TE;;375;381;756
360;ARSOLI;RM;;642;745;1387
361;ARTA TERME;UD;;1029;1027;2056
362;ARTEGNA;UD;;1396;1486;2882
363;ARTENA;RM;;6753;6913;13666
364;ARTOGNE;BS;;1789;1778;3567
365;ARVIER;AO;;415;418;833
366;ARZACHENA;SS;;6746;6582;13328
367;ARZAGO D'ADDA;BG;;1370;1374;2744
368;ARZANA;NU;;1141;1118;2259
369;ARZANO;NA;;15891;16574;32465
370;ARZERGRANDE;PD;;2378;2422;4800
371;ARZIGNANO;VI;;12741;12353;25094
372;ASCEA;SA;;2888;2920;5808
373;ASCIANO;SI;;3309;3503;6812
374;ASCOLI PICENO;AP;;22238;23847;46085
375;ASCOLI SATRIANO;FG;;3023;2902;5925
376;ASCREA;RI;;117;98;215
377;ASIAGO;VI;;3067;3294;6361
378;ASIGLIANO VENETO;VI;;428;416;844
379;ASIGLIANO VERCELLESE;VC;;696;686;1382
380;ASOLA;MN;;4867;5045;9912
381;ASOLO;TV;;4518;4442;8960
382;ASSAGO;MI;;4511;4629;9140
383;ASSEMINI;CA;;12804;13355;26159
384;ASSISI;PG;;13481;14399;27880
385;ASSO;CO;;1740;1788;3528
386;ASSOLO;OR;;179;169;348
387;ASSORO;EN;;2390;2478;4868
388;ASTI;AT;;35488;38235;73723
389;ASUNI;OR;;152;159;311
390;ATELETA;AQ;;553;540;1093
391;ATELLA;PZ;;1842;1839;3681
392;ATENA LUCANA;SA;;1196;1200;2396
393;ATESSA;CH;;5099;5342;10441
394;ATINA;FR;;1989;2140;4129
395;ATRANI;SA;;391;411;802
396;ATRI;TE;;4982;5082;10064
397;ATRIPALDA;AV;;5046;5409;10455
398;ATTIGLIANO;TR;;964;1005;1969
399;ATTIMIS;UD;;808;875;1683
400;ATZARA;NU;;531;495;1026
401;AUGUSTA;SR;;17171;17544;34715
402;AULETTA;SA;;1078;1072;2150
403;AULLA;MS;;5217;5502;10719
404;AURANO;VB;;55;48;103
405;AURIGO;IM;;169;168;337
406;AURONZO DI CADORE;BL;;1505;1605;3110
407;AUSONIA;FR;;1210;1221;2431
408;AUSTIS;NU;;387;385;772
409;AVEGNO;GE;;1265;1254;2519
410;AVELENGO/HAFLING;BZ;;408;403;811
411;AVELLA;AV;;3705;3901;7606
412;AVELLINO;AV;;24788;27710;52498
413;AVERARA;BG;;93;80;173
414;AVERSA;CE;;24136;26058;50194
415;AVETRANA;TA;;3031;3280;6311
416;AVEZZANO;AQ;;19816;21210;41026
417;AVIANO;PN;;4415;4451;8866
418;AVIATICO;BG;;320;255;575
419;AVIGLIANA;TO;;6034;6316;12350
420;AVIGLIANO;PZ;;5223;5493;10716
421;AVIGLIANO UMBRO;TR;;1214;1170;2384
422;AVIO;TN;;2044;2064;4108
423;AVISE;AO;;144;155;299
424;AVOLA;SR;;15008;15466;30474
425;AVOLASCA;AL;;127;126;253
426;AYAS;AO;;683;676;1359
427;AYMAVILLES;AO;;1036;1078;2114
428;AZEGLIO;TO;;611;629;1240
429;AZZANELLO;CR;;297;318;615
430;AZZANO D'ASTI;AT;;181;203;384
431;AZZANO DECIMO;PN;;7784;7876;15660
432;AZZANO MELLA;BS;;1727;1671;3398
433;AZZANO SAN PAOLO;BG;;3693;3903;7596
434;AZZATE;VA;;2231;2390;4621
435;AZZIO;VA;;392;363;755
436;AZZONE;BG;;188;184;372
437;BACENO;VB;;416;453;869
438;BACOLI;NA;;12442;12968;25410
439;BADALUCCO;IM;;521;547;1068
440;BADESI;SS;;908;930;1838
441;BADIA CALAVENA;VR;;1322;1259;2581
442;BADIA PAVESE;PV;;206;188;394
443;BADIA POLESINE;RO;;4885;5135;10020
444;BADIA TEDALDA;AR;;503;468;971
445;BADIA/ABTEI;BZ;;1751;1782;3533
446;BADOLATO;CZ;;1347;1484;2831
447;BAGALADI;RC;;438;515;953
448;BAGHERIA;PA;;25972;27249;53221
449;BAGNACAVALLO;RA;;7997;8401;16398
450;BAGNARA CALABRA;RC;;4665;4708;9373
451;BAGNARA DI ROMAGNA;RA;;1199;1206;2405
452;BAGNARIA;PV;;299;333;632
453;BAGNARIA ARSA;UD;;1710;1743;3453
454;BAGNASCO;CN;;463;510;973
455;BAGNATICA;BG;;2234;2205;4439
456;BAGNI DI LUCCA;LU;;2788;2805;5593
457;BAGNO A RIPOLI;FI;;12039;13275;25314
458;BAGNO DI ROMAGNA;FC;;2743;2875;5618
459;BAGNOLI DEL TRIGNO;IS;;332;317;649
460;BAGNOLI DI SOPRA;PD;;1701;1685;3386
461;BAGNOLI IRPINO;AV;;1511;1518;3029
462;BAGNOLO CREMASCO;CR;;2461;2470;4931
463;BAGNOLO DEL SALENTO;LE;;865;902;1767
464;BAGNOLO DI PO;RO;;633;602;1235
465;BAGNOLO IN PIANO;RE;;4657;4883;9540
466;BAGNOLO MELLA;BS;;6231;6263;12494
467;BAGNOLO PIEMONTE;CN;;2894;2923;5817
468;BAGNOLO SAN VITO;MN;;2905;2945;5850
469;BAGNONE;MS;;855;867;1722
470;BAGNOREGIO;VT;;1659;1823;3482
471;BAGOLINO;BS;;1879;1876;3755
472;BAIA E LATINA;CE;;1004;1032;2036
473;BAIANO;AV;;2183;2332;4515
474;BAIRO;TO;;371;419;790
475;BAISO;RE;;1650;1568;3218
476;BAJARDO;IM;;225;147;372
477;BALANGERO;TO;;1486;1578;3064
478;BALDICHIERI D'ASTI;AT;;541;549;1090
479;BALDISSERO CANAVESE;TO;;259;271;530
480;BALDISSERO D'ALBA;CN;;535;513;1048
481;BALDISSERO TORINESE;TO;;1873;1882;3755
482;BALESTRATE;PA;;2989;3250;6239
483;BALESTRINO;SV;;261;264;525
484;BALLABIO;LC;;2104;2046;4150
485;BALLAO;SU;;376;355;731
486;BALME;TO;;56;49;105
487;BALMUCCIA;VC;;50;60;110
488;BALOCCO;VC;;121;96;217
489;BALSORANO;AQ;;1626;1636;3262
490;BALVANO;PZ;;898;844;1742
491;BALZOLA;AL;;624;637;1261
492;BANARI;SS;;266;269;535
493;BANCHETTE;TO;;1460;1625;3085
494;BANNIO ANZINO;VB;;242;234;476
495;BANZI;PZ;;609;586;1195
496;BAONE;PD;;1552;1515;3067
497;BARADILI;OR;;38;38;76
498;BARAGIANO;PZ;;1259;1275;2534
499;BARANELLO;CB;;1227;1269;2496
500;BARANO D'ISCHIA;NA;;4959;5016;9975
501;BARANZATE;MI;;6105;5657;11762
502;BARASSO;VA;;787;833;1620
503;BARATILI SAN PIETRO;OR;;598;613;1211
504;BARBANIA;TO;;782;788;1570
505;BARBARA;AN;;645;635;1280
506;BARBARANO MOSSANO;VI;;3071;3129;6200
507;BARBARANO ROMANO;VT;;495;495;990
508;BARBARESCO;CN;;304;305;609
509;BARBARIGA;BS;;1183;1134;2317
510;BARBATA;BG;;350;337;687
511;BARBERINO DI MUGELLO;FI;;5393;5491;10884
512;BARBERINO TAVARNELLE;FI;;5933;5973;11906
513;BARBIANELLO;PV;;440;434;874
514;BARBIANO/BARBIAN;BZ;;855;870;1725
515;BARBONA;PD;;311;297;608
516;BARCELLONA POZZO DI GOTTO;ME;;19456;20573;40029
517;BARCIS;PN;;118;108;226
518;BARD;AO;;49;59;108
519;BARDELLO CON MALGESSO E BREGANO;VA;*;1780;1854;3634
520;BARDI;PR;;1034;1009;2043
521;BARDINETO;SV;;359;389;748
522;BARDOLINO;VR;;3397;3606;7003
523;BARDONECCHIA;TO;;1514;1530;3044
524;BAREGGIO;MI;;8416;8758;17174
525;BARENGO;NO;;353;377;730
526;BARESSA;OR;;294;274;568
527;BARETE;AQ;;319;298;617
528;BARGA;LU;;4652;4839;9491
529;BARGAGLI;GE;;1304;1254;2558
530;BARGE;CN;;3717;3713;7430
531;BARGHE;BS;;606;532;1138
532;BARI;BA;;151781;164167;315948
533;BARI SARDO;NU;;1867;1994;3861
534;BARIANO;BG;;2204;2048;4252
535;BARICELLA;BO;;3478;3543;7021
536;BARILE;PZ;;1284;1337;2621
537;BARISCIANO;AQ;;812;857;1669
538;BARLASSINA;MB;;3376;3497;6873
539;BARLETTA;BT;;46054;46744;92798
540;BARNI;CO;;278;281;559
541;BAROLO;CN;;321;339;660
542;BARONE CANAVESE;TO;;269;287;556
543;BARONISSI;SA;;8287;8511;16798
544;BARRAFRANCA;EN;;5664;6336;12000
545;BARRALI;SU;;562;533;1095
546;BARREA;AQ;;356;362;718
547;BARUMINI;SU;;591;585;1176
548;BARZAGO;LC;;1185;1221;2406
549;BARZANA;BG;;1038;966;2004
550;BARZANO';LC;;2448;2545;4993
551;BARZIO;LC;;613;647;1260
552;BASALUZZO;AL;;1010;991;2001
553;BASCAPE';PV;;942;837;1779
554;BASCHI;TR;;1266;1324;2590
555;BASCIANO;TE;;1181;1168;2349
556;BASELGA DI PINE';TN;;2582;2516;5098
557;BASELICE;BN;;1005;1116;2121
558;BASIANO;MI;;1833;1821;3654
559;BASICO';ME;;257;275;532
560;BASIGLIO;MI;;3881;4159;8040
561;BASILIANO;UD;;2599;2634;5233
562;BASSANO BRESCIANO;BS;;1196;1137;2333
563;BASSANO DEL GRAPPA;VI;;20239;22095;42334
564;BASSANO IN TEVERINA;VT;;625;626;1251
565;BASSANO ROMANO;VT;;2306;2321;4627
566;BASSIANO;LT;;749;712;1461
567;BASSIGNANA;AL;;763;793;1556
568;BASTIA MONDOVI';CN;;313;315;628
569;BASTIA UMBRA;PG;;10248;11008;21256
570;BASTIDA PANCARANA;PV;;507;476;983
571;BASTIGLIA;MO;;2060;2066;4126
572;BATTAGLIA TERME;PD;;1853;1929;3782
573;BATTIFOLLO;CN;;117;94;211
574;BATTIPAGLIA;SA;;24420;25235;49655
575;BATTUDA;PV;;351;332;683
576;BAUCINA;PA;;936;939;1875
577;BAULADU;OR;;317;330;647
578;BAUNEI;NU;;1716;1764;3480
579;BAVENO;VB;;2318;2424;4742
580;BEDERO VALCUVIA;VA;;336;329;665
581;BEDIZZOLE;BS;;6121;6157;12278
582;BEDOLLO;TN;;743;729;1472
583;BEDONIA;PR;;1540;1610;3150
584;BEDULITA;BG;;343;362;705
585;BEE;VB;;353;405;758
586;BEINASCO;TO;;8412;9052;17464
587;BEINETTE;CN;;1717;1724;3441
588;BELCASTRO;CZ;;629;598;1227
589;BELFIORE;VR;;1692;1579;3271
590;BELFORTE ALL'ISAURO;PU;;371;378;749
591;BELFORTE DEL CHIENTI;MC;;895;931;1826
592;BELFORTE MONFERRATO;AL;;259;240;499
593;BELGIOIOSO;PV;;3071;3230;6301
594;BELGIRATE;VB;;238;260;498
595;BELLA;PZ;;2365;2362;4727
596;BELLAGIO;CO;;1704;1873;3577
597;BELLANO;LC;;1683;1732;3415
598;BELLANTE;TE;;3373;3473;6846
599;BELLARIA-IGEA MARINA;RN;;9569;9926;19495
600;BELLEGRA;RM;;1323;1384;2707
601;BELLINO;CN;;51;44;95
602;BELLINZAGO LOMBARDO;MI;;1873;1936;3809
603;BELLINZAGO NOVARESE;NO;;4728;4716;9444
604;BELLIZZI;SA;;6544;6751;13295
605;BELLONA;CE;;2957;3082;6039
606;BELLOSGUARDO;SA;;332;373;705
607;BELLUNO;BL;;16900;18495;35395
608;BELLUSCO;MB;;3608;3762;7370
609;BELMONTE CALABRO;CS;;866;914;1780
610;BELMONTE CASTELLO;FR;;359;334;693
611;BELMONTE DEL SANNIO;IS;;301;345;646
612;BELMONTE IN SABINA;RI;;320;325;645
613;BELMONTE MEZZAGNO;PA;;5401;5547;10948
614;BELMONTE PICENO;FM;;284;302;586
615;BELPASSO;CT;;13856;13995;27851
616;BELSITO;CS;;455;437;892
617;BELVEDERE DI SPINELLO;KR;;956;1017;1973
618;BELVEDERE LANGHE;CN;;161;176;337
619;BELVEDERE MARITTIMO;CS;;4241;4662;8903
620;BELVEDERE OSTRENSE;AN;;1039;1057;2096
621;BELVEGLIO;AT;;158;156;314
622;BELVI';NU;;288;272;560
623;BEMA;SO;;59;58;117
624;BENE LARIO;CO;;170;160;330
625;BENE VAGIENNA;CN;;1846;1797;3643
626;BENESTARE;RC;;1252;1226;2478
627;BENETUTTI;SS;;847;879;1726
628;BENEVELLO;CN;;231;236;467
629;BENEVENTO;BN;;27177;29739;56916
630;BENNA;BI;;560;586;1146
631;BENTIVOGLIO;BO;;2832;2868;5700
632;BERBENNO;BG;;1190;1241;2431
633;BERBENNO DI VALTELLINA;SO;;2045;2033;4078
634;BERCETO;PR;;1047;949;1996
635;BERCHIDDA;SS;;1306;1328;2634
636;BEREGAZZO CON FIGLIARO;CO;;1357;1437;2794
637;BEREGUARDO;PV;;1432;1429;2861
638;BERGAMASCO;AL;;343;366;709
639;BERGAMO;BG;;56641;62835;119476
640;BERGANTINO;RO;;1193;1229;2422
641;BERGEGGI;SV;;520;548;1068
642;BERGOLO;CN;;30;25;55
643;BERLINGO;BS;;1427;1325;2752
644;BERNALDA;MT;;5977;5987;11964
645;BERNAREGGIO;MB;;5760;5625;11385
646;BERNATE TICINO;MI;;1473;1503;2976
647;BERNEZZO;CN;;2080;2139;4219
648;BERTINORO;FC;;5397;5587;10984
649;BERTIOLO;UD;;1166;1210;2376
650;BERTONICO;LO;;547;524;1071
651;BERZANO DI SAN PIETRO;AT;;219;178;397
652;BERZANO DI TORTONA;AL;;76;81;157
653;BERZO DEMO;BS;;789;736;1525
654;BERZO INFERIORE;BS;;1221;1226;2447
655;BERZO SAN FERMO;BG;;739;689;1428
656;BESANA IN BRIANZA;MB;;7626;7816;15442
657;BESANO;VA;;1247;1262;2509
658;BESATE;MI;;1024;1004;2028
659;BESENELLO;TN;;1385;1369;2754
660;BESENZONE;PC;;469;469;938
661;BESNATE;VA;;2685;2790;5475
662;BESOZZO;VA;;4226;4530;8756
663;BESSUDE;SS;;186;205;391
664;BETTOLA;PC;;1321;1287;2608
665;BETTONA;PG;;2074;2214;4288
666;BEURA-CARDEZZA;VB;;720;717;1437
667;BEVAGNA;PG;;2374;2403;4777
668;BEVERINO;SP;;1122;1142;2264
669;BEVILACQUA;VR;;894;877;1771
670;BIANCAVILLA;CT;;11164;11867;23031
671;BIANCHI;CS;;621;589;1210
672;BIANCO;RC;;2063;2125;4188
673;BIANDRATE;NO;;666;641;1307
674;BIANDRONNO;VA;;1549;1618;3167
675;BIANZANO;BG;;305;297;602
676;BIANZE';VC;;900;941;1841
677;BIANZONE;SO;;636;626;1262
678;BIASSONO;MB;;5885;6332;12217
679;BIBBIANO;RE;;5064;5119;10183
680;BIBBIENA;AR;;5860;5946;11806
681;BIBBONA;LI;;1609;1563;3172
682;BIBIANA;TO;;1696;1682;3378
683;BICCARI;FG;;1305;1335;2640
684;BICINICCO;UD;;895;916;1811
685;BIDONI';OR;;64;64;128
686;BIELLA;BI;;20202;22581;42783
687;BIENNO;BS;;1850;1910;3760
688;BIENO;TN;;216;234;450
689;BIENTINA;PI;;4152;4401;8553
690;BINAGO;CO;;2403;2421;4824
691;BINASCO;MI;;3369;3717;7086
692;BINETTO;BA;;1066;1072;2138
693;BIOGLIO;BI;;469;436;905
694;BIONAZ;AO;;114;104;218
695;BIONE;BS;;657;654;1311
696;BIRORI;NU;;241;258;499
697;BISACCIA;AV;;1777;1777;3554
698;BISACQUINO;PA;;2048;2142;4190
699;BISCEGLIE;BT;;26573;27165;53738
700;BISEGNA;AQ;;95;112;207
701;BISENTI;TE;;866;830;1696
702;BISIGNANO;CS;;4796;4818;9614
703;BISTAGNO;AL;;876;889;1765
704;BISUSCHIO;VA;;2071;2179;4250
705;BITETTO;BA;;5772;6022;11794
706;BITONTO;BA;;26302;27094;53396
707;BITRITTO;BA;;5545;5742;11287
708;BITTI;NU;;1269;1341;2610
709;BIVONA;AG;;1593;1664;3257
710;BIVONGI;RC;;562;601;1163
711;BIZZARONE;CO;;862;863;1725
712;BLEGGIO SUPERIORE;TN;;784;750;1534
713;BLELLO;BG;;33;39;72
714;BLERA;VT;;1480;1523;3003
715;BLESSAGNO;CO;;152;138;290
716;BLEVIO;CO;;519;572;1091
717;BLUFI;PA;;423;470;893
718;BOARA PISANI;PD;;1196;1197;2393
719;BOBBIO;PC;;1631;1786;3417
720;BOBBIO PELLICE;TO;;259;280;539
721;BOCA;NO;;559;572;1131
722;BOCCHIGLIERO;CS;;500;591;1091
723;BOCCIOLETO;VC;;78;85;163
724;BOCENAGO;TN;;198;202;400
725;BODIO LOMNAGO;VA;;1086;1145;2231
726;BOFFALORA D'ADDA;LO;;871;860;1731
727;BOFFALORA SOPRA TICINO;MI;;2042;2068;4110
728;BOGLIASCO;GE;;2101;2278;4379
729;BOGNANCO;VB;;106;85;191
730;BOGOGNO;NO;;637;660;1297
731;BOISSANO;SV;;1271;1256;2527
732;BOJANO;CB;;3657;3845;7502
733;BOLANO;SP;;3649;3802;7451
734;BOLGARE;BG;;3292;3229;6521
735;BOLLATE;MI;;17351;18815;36166
736;BOLLENGO;TO;;1065;1033;2098
737;BOLOGNA;BO;;184660;203182;387842
738;BOLOGNANO;PE;;509;515;1024
739;BOLOGNETTA;PA;;2023;2074;4097
740;BOLOGNOLA;MC;;81;64;145
741;BOLOTANA;NU;;1119;1300;2419
742;BOLSENA;VT;;1806;1933;3739
743;BOLTIERE;BG;;3168;3042;6210
744;BOLZANO NOVARESE;NO;;589;560;1149
745;BOLZANO VICENTINO;VI;;3229;3275;6504
746;BOLZANO/BOZEN;BZ;;51445;55156;106601
747;BOMARZO;VT;;859;833;1692
748;BOMBA;CH;;367;360;727
749;BOMPENSIERE;CL;;258;255;513
750;BOMPIETRO;PA;;583;641;1224
751;BOMPORTO;MO;;5104;5040;10144
752;BONARCADO;OR;;769;750;1519
753;BONASSOLA;SP;;392;424;816
754;BONATE SOPRA;BG;;5144;5098;10242
755;BONATE SOTTO;BG;;3317;3312;6629
756;BONAVIGO;VR;;1046;964;2010
757;BONDENO;FE;;6766;7106;13872
758;BONDONE;TN;;328;315;643
759;BONEA;BN;;699;684;1383
760;BONEFRO;CB;;586;628;1214
761;BONEMERSE;CR;;721;743;1464
762;BONIFATI;CS;;1260;1364;2624
763;BONITO;AV;;1114;1128;2242
764;BONNANARO;SS;;444;486;930
765;BONO;SS;;1651;1705;3356
766;BONORVA;SS;;1633;1598;3231
767;BONVICINO;CN;;47;53;100
768;BORBONA;RI;;307;282;589
769;BORCA DI CADORE;BL;;417;409;826
770;BORDANO;UD;;351;359;710
771;BORDIGHERA;IM;;4735;5395;10130
772;BORDOLANO;CR;;287;276;563
773;BORE;PR;;351;325;676
774;BORETTO;RE;;2602;2650;5252
775;BORGARELLO;PV;;1303;1359;2662
776;BORGARO TORINESE;TO;;5734;6093;11827
777;BORGETTO;PA;;3533;3601;7134
778;BORGHETTO D'ARROSCIA;IM;;219;189;408
779;BORGHETTO DI BORBERA;AL;;977;947;1924
780;BORGHETTO DI VARA;SP;;432;446;878
781;BORGHETTO LODIGIANO;LO;;2164;2124;4288
782;BORGHETTO SANTO SPIRITO;SV;;2193;2419;4612
783;BORGHI;FC;;1444;1438;2882
784;BORGIA;CZ;;3519;3699;7218
785;BORGIALLO;TO;;287;295;582
786;BORGIO VEREZZI;SV;;980;1106;2086
787;BORGO A MOZZANO;LU;;3293;3374;6667
788;BORGO CHIESE;TN;;990;964;1954
789;BORGO D'ALE;VC;;1108;1115;2223
790;BORGO D'ANAUNIA;TN;;1248;1256;2504
791;BORGO DI TERZO;BG;;578;569;1147
792;BORGO LARES;TN;;378;342;720
793;BORGO MANTOVANO;MN;;2571;2748;5319
794;BORGO PACE;PU;;273;259;532
795;BORGO PRIOLO;PV;;677;642;1319
796;BORGO SAN DALMAZZO;CN;;6163;6314;12477
797;BORGO SAN GIACOMO;BS;;2749;2639;5388
798;BORGO SAN GIOVANNI;LO;;1227;1208;2435
799;BORGO SAN LORENZO;FI;;8832;9352;18184
800;BORGO SAN MARTINO;AL;;672;671;1343
801;BORGO SAN SIRO;PV;;481;472;953
802;BORGO TICINO;NO;;2601;2573;5174
803;BORGO TOSSIGNANO;BO;;1614;1626;3240
804;BORGO VAL DI TARO;PR;;3285;3438;6723
805;BORGO VALBELLUNA;BL;;6622;6835;13457
806;BORGO VALSUGANA;TN;;3425;3553;6978
807;BORGO VELINO;RI;;447;493;940
808;BORGO VENETO;PD;;3513;3540;7053
809;BORGO VERCELLI;VC;;1109;1151;2260
810;BORGO VIRGILIO;MN;;7323;7455;14778
811;BORGOCARBONARA;MN;;950;951;1901
812;BORGOFRANCO D'IVREA;TO;;1707;1848;3555
813;BORGOLAVEZZARO;NO;;942;1014;1956
814;BORGOMALE;CN;;184;202;386
815;BORGOMANERO;NO;;10245;11032;21277
816;BORGOMARO;IM;;430;397;827
817;BORGOMASINO;TO;;373;400;773
818;BORGOMEZZAVALLE;VB;;142;150;292
819;BORGONE SUSA;TO;;1084;1067;2151
820;BORGONOVO VAL TIDONE;PC;;4022;4004;8026
821;BORGORATTO ALESSANDRINO;AL;;253;283;536
822;BORGORATTO MORMOROLO;PV;;203;214;417
823;BORGORICCO;PD;;4486;4420;8906
824;BORGOROSE;RI;;2194;2053;4247
825;BORGOSATOLLO;BS;;4544;4517;9061
826;BORGOSESIA;VC;;5795;6394;12189
827;BORMIDA;SV;;174;169;343
828;BORMIO;SO;;1953;2037;3990
829;BORNASCO;PV;;1359;1312;2671
830;BORNO;BS;;1210;1269;2479
831;BORONEDDU;OR;;71;83;154
832;BORORE;NU;;973;1021;1994
833;BORRELLO;CH;;152;154;306
834;BORRIANA;BI;;408;453;861
835;BORSO DEL GRAPPA;TV;;2939;2939;5878
836;BORTIGALI;NU;;577;628;1205
837;BORTIGIADAS;SS;;361;368;729
838;BORUTTA;SS;;124;136;260
839;BORZONASCA;GE;;943;891;1834
840;BOSA;OR;;3676;3863;7539
841;BOSARO;RO;;723;728;1451
842;BOSCHI SANT'ANNA;VR;;669;692;1361
843;BOSCO CHIESANUOVA;VR;;1901;1659;3560
844;BOSCO MARENGO;AL;;1146;1095;2241
845;BOSCONERO;TO;;1517;1549;3066
846;BOSCOREALE;NA;;12985;13332;26317
847;BOSCOTRECASE;NA;;4847;5050;9897
848;BOSIA;CN;;83;87;170
849;BOSIO;AL;;554;508;1062
850;BOSISIO PARINI;LC;;1671;1641;3312
851;BOSNASCO;PV;;326;310;636
852;BOSSICO;BG;;496;480;976
853;BOSSOLASCO;CN;;306;333;639
854;BOTRICELLO;CZ;;2483;2543;5026
855;BOTRUGNO;LE;;1226;1387;2613
856;BOTTANUCO;BG;;2539;2501;5040
857;BOTTICINO;BS;;5221;5485;10706
858;BOTTIDDA;SS;;324;327;651
859;BOVA;RC;;217;183;400
860;BOVA MARINA;RC;;2023;2057;4080
861;BOVALINO;RC;;4179;4493;8672
862;BOVEGNO;BS;;989;1036;2025
863;BOVES;CN;;4787;4854;9641
864;BOVEZZO;BS;;3554;3802;7356
865;BOVILLE ERNICA;FR;;4190;4233;8423
866;BOVINO;FG;;1464;1534;2998
867;BOVISIO-MASCIAGO;MB;;8194;8562;16756
868;BOVOLENTA;PD;;1731;1718;3449
869;BOVOLONE;VR;;7963;8068;16031
870;BOZZOLE;AL;;165;146;311
871;BOZZOLO;MN;;1988;2066;4054
872;BRA;CN;;14344;15192;29536
873;BRACCA;BG;;366;358;724
874;BRACCIANO;RM;;8944;9599;18543
875;BRACIGLIANO;SA;;2671;2665;5336
876;BRAIES/PRAGS;BZ;;342;349;691
877;BRALLO DI PREGOLA;PV;;271;243;514
878;BRANCALEONE;RC;;1607;1675;3282
879;BRANDICO;BS;;905;839;1744
880;BRANDIZZO;TO;;4266;4435;8701
881;BRANZI;BG;;333;334;667
882;BRAONE;BS;;346;336;682
883;BREBBIA;VA;;1556;1599;3155
884;BREDA DI PIAVE;TV;;3831;3828;7659
885;BREGANZE;VI;;4090;4291;8381
886;BREGNANO;CO;;3229;3155;6384
887;BREMBATE;BG;;4298;4215;8513
888;BREMBATE DI SOPRA;BG;;3939;3981;7920
889;BREMBIO;LO;;1387;1305;2692
890;BREME;PV;;352;363;715
891;BRENDOLA;VI;;3304;3335;6639
892;BRENNA;CO;;1107;1070;2177
893;BRENNERO/BRENNER;BZ;;1212;1096;2308
894;BRENO;BS;;2262;2370;4632
895;BRENTA;VA;;856;879;1735
896;BRENTINO BELLUNO;VR;;692;658;1350
897;BRENTONICO;TN;;2012;2030;4042
898;BRENZONE SUL GARDA;VR;;1146;1310;2456
899;BRESCELLO;RE;;2832;2791;5623
900;BRESCIA;BS;;94052;101854;195906
901;BRESIMO;TN;;126;124;250
902;BRESSANA BOTTARONE;PV;;1696;1747;3443
903;BRESSANONE/BRIXEN;BZ;;11085;11643;22728
904;BRESSANVIDO;VI;;1586;1581;3167
905;BRESSO;MI;;12677;13404;26081
906;BREZZO DI BEDERO;VA;;654;592;1246
907;BRIAGLIA;CN;;160;145;305
908;BRIATICO;VV;;1960;1821;3781
909;BRICHERASIO;TO;;2301;2315;4616
910;BRIENNO;CO;;161;174;335
911;BRIENZA;PZ;;1919;1936;3855
912;BRIGA ALTA;CN;;28;12;40
913;BRIGA NOVARESE;NO;;1333;1430;2763
914;BRIGNANO FRASCATA;AL;;219;207;426
915;BRIGNANO GERA D'ADDA;BG;;3033;3065;6098
916;BRINDISI;BR;;40026;43291;83317
917;BRINDISI MONTAGNA;PZ;;421;390;811
918;BRINZIO;VA;;402;371;773
919;BRIONA;NO;;535;570;1105
920;BRIONE;BS;;393;344;737
921;BRIOSCO;MB;;3023;3068;6091
922;BRISIGHELLA;RA;;3593;3596;7189
923;BRISSAGO-VALTRAVAGLIA;VA;;610;635;1245
924;BRISSOGNE;AO;;490;458;948
925;BRITTOLI;PE;;133;133;266
926;BRIVIO;LC;;2248;2211;4459
927;BROCCOSTELLA;FR;;1322;1362;2684
928;BROGLIANO;VI;;2033;1982;4015
929;BROGNATURO;VV;;359;309;668
930;BROLO;ME;;2743;3010;5753
931;BRONDELLO;CN;;143;118;261
932;BRONI;PV;;4598;4987;9585
933;BRONTE;CT;;8798;9509;18307
934;BRONZOLO/BRANZOLL;BZ;;1372;1386;2758
935;BROSSASCO;CN;;504;501;1005
936;BROSSO;TO;;189;205;394
937;BROVELLO-CARPUGNINO;VB;;395;379;774
938;BROZOLO;TO;;240;214;454
939;BRUGHERIO;MB;;16971;17899;34870
940;BRUGINE;PD;;3519;3628;7147
941;BRUGNATO;SP;;634;650;1284
942;BRUGNERA;PN;;4669;4599;9268
943;BRUINO;TO;;4161;4328;8489
944;BRUMANO;BG;;69;53;122
945;BRUNATE;CO;;812;811;1623
946;BRUNELLO;VA;;457;472;929
947;BRUNICO/BRUNECK;BZ;;8436;8559;16995
948;BRUNO;AT;;144;153;297
949;BRUSAPORTO;BG;;2790;2842;5632
950;BRUSASCO;TO;;756;734;1490
951;BRUSCIANO;NA;;7802;8087;15889
952;BRUSIMPIANO;VA;;584;586;1170
953;BRUSNENGO;BI;;967;1008;1975
954;BRUSSON;AO;;422;439;861
955;BRUZOLO;TO;;739;753;1492
956;BRUZZANO ZEFFIRIO;RC;;501;555;1056
957;BUBBIANO;MI;;1240;1220;2460
958;BUBBIO;AT;;384;418;802
959;BUCCHERI;SR;;831;934;1765
960;BUCCHIANICO;CH;;2444;2536;4980
961;BUCCIANO;BN;;985;1015;2000
962;BUCCINASCO;MI;;13065;13847;26912
963;BUCCINO;SA;;2305;2356;4661
964;BUCINE;AR;;4861;5049;9910
965;BUDDUSO';SS;;1843;1816;3659
966;BUDOIA;PN;;1249;1243;2492
967;BUDONI;SS;;2647;2686;5333
968;BUDRIO;BO;;8976;9318;18294
969;BUGGERRU;SU;;537;516;1053
970;BUGGIANO;PT;;4223;4523;8746
971;BUGLIO IN MONTE;SO;;990;977;1967
972;BUGNARA;AQ;;514;520;1034
973;BUGUGGIATE;VA;;1494;1581;3075
974;BUJA;UD;;3069;3268;6337
975;BULCIAGO;LC;;1458;1408;2866
976;BULGAROGRASSO;CO;;2016;1986;4002
977;BULTEI;SS;;413;428;841
978;BULZI;SS;;251;219;470
979;BUONABITACOLO;SA;;1185;1231;2416
980;BUONALBERGO;BN;;779;783;1562
981;BUONCONVENTO;SI;;1455;1549;3004
982;BUONVICINO;CS;;990;1058;2048
983;BURAGO DI MOLGORA;MB;;2037;2169;4206
984;BURCEI;SU;;1348;1318;2666
985;BURGIO;AG;;1222;1287;2509
986;BURGOS;SS;;427;429;856
987;BURIASCO;TO;;655;682;1337
988;BUROLO;TO;;523;582;1105
989;BURONZO;VC;;418;433;851
990;BUSACHI;OR;;567;605;1172
991;BUSALLA;GE;;2540;2628;5168
992;BUSANO;TO;;838;784;1622
993;BUSCA;CN;;5110;5017;10127
994;BUSCATE;MI;;2284;2349;4633
995;BUSCEMI;SR;;491;477;968
996;BUSETO PALIZZOLO;TP;;1361;1444;2805
997;BUSNAGO;MB;;3351;3413;6764
998;BUSSERO;MI;;4019;4322;8341
999;BUSSETO;PR;;3386;3381;6767
1000;BUSSI SUL TIRINO;PE;;1127;1169;2296
1001;BUSSO;CB;;587;583;1170
1002;BUSSOLENGO;VR;;10133;10530;20663
1003;BUSSOLENO;TO;;2726;2926;5652
1004;BUSTO ARSIZIO;VA;;39878;42876;82754
1005;BUSTO GAROLFO;MI;;7010;7033;14043
1006;BUTERA;CL;;2054;2145;4199
1007;BUTI;PI;;2739;2836;5575
1008;BUTTAPIETRA;VR;;3521;3466;6987
1009;BUTTIGLIERA ALTA;TO;;3091;3213;6304
1010;BUTTIGLIERA D'ASTI;AT;;1260;1236;2496
1011;BUTTRIO;UD;;1923;1955;3878
1012;CABELLA LIGURE;AL;;244;224;468
1013;CABIATE;CO;;3703;3702;7405
1014;CABRAS;OR;;4377;4432;8809
1015;CACCAMO;PA;;3825;3922;7747
1016;CACCURI;KR;;759;794;1553
1017;CADEGLIANO-VICONAGO;VA;;1029;1102;2131
1018;CADELBOSCO DI SOPRA;RE;;5278;5360;10638
1019;CADEO;PC;;2958;3025;5983
1020;CADERZONE TERME;TN;;353;347;700
1021;CADONEGHE;PD;;7628;8145;15773
1022;CADORAGO;CO;;3950;3981;7931
1023;CADREZZATE CON OSMATE;VA;;1297;1354;2651
1024;CAERANO DI SAN MARCO;TV;;3862;3987;7849
1025;CAFASSE;TO;;1655;1655;3310
1026;CAGGIANO;SA;;1265;1283;2548
1027;CAGLI;PU;;3912;4156;8068
1028;CAGLIARI;CA;;69339;79753;149092
1029;CAGLIO;CO;;230;245;475
1030;CAGNANO AMITERNO;AQ;;571;581;1152
1031;CAGNANO VARANO;FG;;3271;3377;6648
1032;CAIANELLO;CE;;857;904;1761
1033;CAIAZZO;CE;;2563;2661;5224
1034;CAINES/KUENS;BZ;;192;196;388
1035;CAINO;BS;;1086;1050;2136
1036;CAIOLO;SO;;527;521;1048
1037;CAIRANO;AV;;134;141;275
1038;CAIRATE;VA;;3827;3902;7729
1039;CAIRO MONTENOTTE;SV;;6231;6417;12648
1040;CAIVANO;NA;;17804;18244;36048
1041;CALABRITTO;AV;;1075;1110;2185
1042;CALALZO DI CADORE;BL;;908;949;1857
1043;CALAMANDRANA;AT;;815;846;1661
1044;CALAMONACI;AG;;584;600;1184
1045;CALANGIANUS;SS;;1925;1928;3853
1046;CALANNA;RC;;375;407;782
1047;CALASCA-CASTIGLIONE;VB;;286;281;567
1048;CALASCIBETTA;EN;;2026;2140;4166
1049;CALASCIO;AQ;;68;65;133
1050;CALASETTA;SU;;1406;1396;2802
1051;CALATABIANO;CT;;2563;2604;5167
1052;CALATAFIMI SEGESTA;TP;;3061;3182;6243
1053;CALCATA;VT;;442;473;915
1054;CALCERANICA AL LAGO;TN;;688;698;1386
1055;CALCI;PI;;3029;3264;6293
1056;CALCIANO;MT;;336;331;667
1057;CALCINAIA;PI;;6212;6499;12711
1058;CALCINATE;BG;;3161;2928;6089
1059;CALCINATO;BS;;6534;6356;12890
1060;CALCIO;BG;;2788;2598;5386
1061;CALCO;LC;;2662;2671;5333
1062;CALDARO SULLA STRADA DEL VINO/KALTERN AN DER WEINSTRASSE;BZ;;3987;4120;8107
1063;CALDAROLA;MC;;814;825;1639
1064;CALDERARA DI RENO;BO;;6612;6822;13434
1065;CALDES;TN;;539;548;1087
1066;CALDIERO;VR;;4009;3887;7896
1067;CALDOGNO;VI;;5546;5775;11321
1068;CALDONAZZO;TN;;1906;1994;3900
1069;CALENDASCO;PC;;1218;1179;2397
1070;CALENZANO;FI;;8886;9155;18041
1071;CALESTANO;PR;;1082;978;2060
1072;CALICE AL CORNOVIGLIO;SP;;534;519;1053
1073;CALICE LIGURE;SV;;834;858;1692
1074;CALIMERA;LE;;3165;3612;6777
1075;CALITRI;AV;;2059;2219;4278
1076;CALIZZANO;SV;;695;728;1423
1077;CALLABIANA;BI;;79;68;147
1078;CALLIANO;TN;;1022;998;2020
1079;CALLIANO MONFERRATO;AT;;600;609;1209
1080;CALOLZIOCORTE;LC;;6597;6910;13507
1081;CALOPEZZATI;CS;;655;646;1301
1082;CALOSSO;AT;;593;553;1146
1083;CALOVETO;CS;;557;574;1131
1084;CALTABELLOTTA;AG;;1538;1700;3238
1085;CALTAGIRONE;CT;;17622;18436;36058
1086;CALTANISSETTA;CL;;28633;30612;59245
1087;CALTAVUTURO;PA;;1751;1861;3612
1088;CALTIGNAGA;NO;;1239;1265;2504
1089;CALTO;RO;;324;335;659
1090;CALTRANO;VI;;1262;1265;2527
1091;CALUSCO D'ADDA;BG;;4094;4137;8231
1092;CALUSO;TO;;3586;3802;7388
1093;CALVAGESE DELLA RIVIERA;BS;;1827;1817;3644
1094;CALVANICO;SA;;700;697;1397
1095;CALVATONE;CR;;607;567;1174
1096;CALVELLO;PZ;;848;916;1764
1097;CALVENE;VI;;642;647;1289
1098;CALVENZANO;BG;;2136;2143;4279
1099;CALVERA;PZ;;181;177;358
1100;CALVI;BN;;1241;1274;2515
1101;CALVI DELL'UMBRIA;TR;;829;868;1697
1102;CALVI RISORTA;CE;;2650;2868;5518
1103;CALVIGNANO;PV;;54;52;106
1104;CALVIGNASCO;MI;;608;614;1222
1105;CALVISANO;BS;;4268;4107;8375
1106;CALVIZZANO;NA;;6103;6294;12397
1107;CAMAGNA MONFERRATO;AL;;227;241;468
1108;CAMAIORE;LU;;15381;16440;31821
1109;CAMANDONA;BI;;155;156;311
1110;CAMASTRA;AG;;952;995;1947
1111;CAMBIAGO;MI;;3581;3537;7118
1112;CAMBIANO;TO;;2835;3065;5900
1113;CAMBIASCA;VB;;761;807;1568
1114;CAMBURZANO;BI;;536;584;1120
1115;CAMERANA;CN;;291;284;575
1116;CAMERANO;AN;;3469;3638;7107
1117;CAMERANO CASASCO;AT;;205;202;407
1118;CAMERATA CORNELLO;BG;;272;286;558
1119;CAMERATA NUOVA;RM;;213;197;410
1120;CAMERATA PICENA;AN;;1258;1248;2506
1121;CAMERI;NO;;5196;5464;10660
1122;CAMERINO;MC;;3064;3204;6268
1123;CAMEROTA;SA;;3430;3452;6882
1124;CAMIGLIANO;CE;;1004;989;1993
1125;CAMINI;RC;;383;425;808
1126;CAMINO;AL;;381;355;736
1127;CAMINO AL TAGLIAMENTO;UD;;759;785;1544
1128;CAMISANO;CR;;614;623;1237
1129;CAMISANO VICENTINO;VI;;5525;5640;11165
1130;CAMMARATA;AG;;2955;2965;5920
1131;CAMOGLI;GE;;2442;2580;5022
1132;CAMPAGNA;SA;;8315;8247;16562
1133;CAMPAGNA LUPIA;VE;;3527;3601;7128
1134;CAMPAGNANO DI ROMA;RM;;5340;5752;11092
1135;CAMPAGNATICO;GR;;1196;1139;2335
1136;CAMPAGNOLA CREMASCA;CR;;325;337;662
1137;CAMPAGNOLA EMILIA;RE;;2749;2751;5500
1138;CAMPANA;CS;;733;776;1509
1139;CAMPARADA;MB;;1129;1027;2156
1140;CAMPEGINE;RE;;2619;2673;5292
1141;CAMPELLO SUL CLITUNNO;PG;;1149;1198;2347
1142;CAMPERTOGNO;VC;;110;111;221
1143;CAMPI BISENZIO;FI;;23569;23972;47541
1144;CAMPI SALENTINA;LE;;4735;5150;9885
1145;CAMPIGLIA CERVO;BI;;266;255;521
1146;CAMPIGLIA DEI BERICI;VI;;838;831;1669
1147;CAMPIGLIA MARITTIMA;LI;;6030;6508;12538
1148;CAMPIGLIONE FENILE;TO;;657;673;1330
1149;CAMPIONE D'ITALIA;CO;;830;918;1748
1150;CAMPITELLO DI FASSA;TN;;346;361;707
1151;CAMPLI;TE;;3314;3316;6630
1152;CAMPO CALABRO;RC;;2179;2270;4449
1153;CAMPO DI GIOVE;AQ;;381;369;750
1154;CAMPO DI TRENS/FREIENFELD;BZ;;1388;1291;2679
1155;CAMPO LIGURE;GE;;1415;1375;2790
1156;CAMPO NELL'ELBA;LI;;2328;2378;4706
1157;CAMPO SAN MARTINO;PD;;2847;2805;5652
1158;CAMPO TURES/SAND IN TAUFERS;BZ;;2818;2867;5685
1159;CAMPOBASSO;CB;;22888;24699;47587
1160;CAMPOBELLO DI LICATA;AG;;4468;4707;9175
1161;CAMPOBELLO DI MAZARA;TP;;5727;5736;11463
1162;CAMPOCHIARO;CB;;289;306;595
1163;CAMPODARSEGO;PD;;7363;7580;14943
1164;CAMPODENNO;TN;;779;733;1512
1165;CAMPODIMELE;LT;;296;265;561
1166;CAMPODIPIETRA;CB;;1180;1255;2435
1167;CAMPODOLCINO;SO;;466;462;928
1168;CAMPODORO;PD;;1311;1305;2616
1169;CAMPOFELICE DI FITALIA;PA;;241;226;467
1170;CAMPOFELICE DI ROCCELLA;PA;;3776;3829;7605
1171;CAMPOFILONE;FM;;964;946;1910
1172;CAMPOFIORITO;PA;;579;600;1179
1173;CAMPOFORMIDO;UD;;3850;4007;7857
1174;CAMPOFRANCO;CL;;1281;1435;2716
1175;CAMPOGALLIANO;MO;;4226;4352;8578
1176;CAMPOLATTARO;BN;;484;488;972
1177;CAMPOLI APPENNINO;FR;;802;808;1610
1178;CAMPOLI DEL MONTE TABURNO;BN;;877;717;1594
1179;CAMPOLIETO;CB;;408;392;800
1180;CAMPOLONGO MAGGIORE;VE;;5336;5389;10725
1181;CAMPOLONGO TAPOGLIANO;UD;;557;575;1132
1182;CAMPOMAGGIORE;PZ;;356;374;730
1183;CAMPOMARINO;CB;;3958;3690;7648
1184;CAMPOMORONE;GE;;3149;3333;6482
1185;CAMPONOGARA;VE;;6389;6616;13005
1186;CAMPORA;SA;;169;156;325
1187;CAMPOREALE;PA;;1488;1527;3015
1188;CAMPORGIANO;LU;;1020;1021;2041
1189;CAMPOROSSO;IM;;2755;2822;5577
1190;CAMPOROTONDO DI FIASTRONE;MC;;234;267;501
1191;CAMPOROTONDO ETNEO;CT;;2644;2569;5213
1192;CAMPOSAMPIERO;PD;;5904;5963;11867
1193;CAMPOSANO;NA;;2457;2645;5102
1194;CAMPOSANTO;MO;;1643;1618;3261
1195;CAMPOSPINOSO ALBAREDO;PV;;649;667;1316
1196;CAMPOTOSTO;AQ;;245;228;473
1197;CAMUGNANO;BO;;905;899;1804
1198;CANAL SAN BOVO;TN;;710;762;1472
1199;CANALE;CN;;2718;2796;5514
1200;CANALE D'AGORDO;BL;;527;542;1069
1201;CANALE MONTERANO;RM;;2031;2125;4156
1202;CANARO;RO;;1280;1319;2599
1203;CANAZEI;TN;;895;983;1878
1204;CANCELLARA;PZ;;572;595;1167
1205;CANCELLO ED ARNONE;CE;;2794;2717;5511
1206;CANDA;RO;;422;433;855
1207;CANDELA;FG;;1277;1263;2540
1208;CANDELO;BI;;3482;3789;7271
1209;CANDIA CANAVESE;TO;;592;617;1209
1210;CANDIA LOMELLINA;PV;;729;716;1445
1211;CANDIANA;PD;;1127;1087;2214
1212;CANDIDA;AV;;571;533;1104
1213;CANDIDONI;RC;;211;207;418
1214;CANDIOLO;TO;;2786;2824;5610
1215;CANEGRATE;MI;;6112;6387;12499
1216;CANELLI;AT;;5002;5179;10181
1217;CANEPINA;VT;;1445;1468;2913
1218;CANEVA;PN;;3067;3187;6254
1219;CANICATTI';AG;;16744;17844;34588
1220;CANICATTINI BAGNI;SR;;3170;3449;6619
1221;CANINO;VT;;2564;2525;5089
1222;CANISCHIO;TO;;149;137;286
1223;CANISTRO;AQ;;439;472;911
1224;CANNA;CS;;313;336;649
1225;CANNALONGA;SA;;496;485;981
1226;CANNARA;PG;;2057;2141;4198
1227;CANNERO RIVIERA;VB;;451;459;910
1228;CANNETO PAVESE;PV;;645;661;1306
1229;CANNETO SULL'OGLIO;MN;;2140;2097;4237
1230;CANNOBIO;VB;;2419;2581;5000
1231;CANNOLE;LE;;811;820;1631
1232;CANOLO;RC;;350;353;703
1233;CANONICA D'ADDA;BG;;2180;2055;4235
1234;CANOSA DI PUGLIA;BT;;13933;14254;28187
1235;CANOSA SANNITA;CH;;629;659;1288
1236;CANOSIO;CN;;43;36;79
1237;CANOSSA;RE;;1891;1817;3708
1238;CANSANO;AQ;;93;112;205
1239;CANTAGALLO;PO;;1612;1480;3092
1240;CANTALICE;RI;;1212;1245;2457
1241;CANTALUPA;TO;;1291;1311;2602
1242;CANTALUPO IN SABINA;RI;;813;829;1642
1243;CANTALUPO LIGURE;AL;;222;232;454
1244;CANTALUPO NEL SANNIO;IS;;390;335;725
1245;CANTARANA;AT;;496;491;987
1246;CANTELLO;VA;;2317;2409;4726
1247;CANTERANO;RM;;190;166;356
1248;CANTIANO;PU;;1000;1026;2026
1249;CANTOIRA;TO;;316;280;596
1250;CANTU';CO;;19320;20062;39382
1251;CANZANO;TE;;893;901;1794
1252;CANZO;CO;;2484;2627;5111
1253;CAORLE;VE;;5397;5758;11155
1254;CAORSO;PC;;2348;2353;4701
1255;CAPACCIO PAESTUM;SA;;11270;11061;22331
1256;CAPACI;PA;;5604;5729;11333
1257;CAPALBIO;GR;;1879;2008;3887
1258;CAPANNOLI;PI;;3160;3270;6430
1259;CAPANNORI;LU;;22908;23482;46390
1260;CAPENA;RM;;5464;5269;10733
1261;CAPERGNANICA;CR;;1090;1058;2148
1262;CAPESTRANO;AQ;;406;434;840
1263;CAPIAGO INTIMIANO;CO;;2676;2798;5474
1264;CAPISTRANO;VV;;475;505;980
1265;CAPISTRELLO;AQ;;2385;2490;4875
1266;CAPITIGNANO;AQ;;303;316;619
1267;CAPIZZI;ME;;1401;1487;2888
1268;CAPIZZONE;BG;;596;610;1206
1269;CAPO D'ORLANDO;ME;;6182;6920;13102
1270;CAPO DI PONTE;BS;;1118;1209;2327
1271;CAPODIMONTE;VT;;816;839;1655
1272;CAPODRISE;CE;;4954;5111;10065
1273;CAPOLIVERI;LI;;1934;1944;3878
1274;CAPOLONA;AR;;2538;2706;5244
1275;CAPONAGO;MB;;2552;2571;5123
1276;CAPORCIANO;AQ;;110;96;206
1277;CAPOSELE;AV;;1605;1666;3271
1278;CAPOTERRA;CA;;11544;11691;23235
1279;CAPOVALLE;BS;;170;175;345
1280;CAPPADOCIA;AQ;;319;244;563
1281;CAPPELLA CANTONE;CR;;263;280;543
1282;CAPPELLA DE' PICENARDI;CR;;208;208;416
1283;CAPPELLA MAGGIORE;TV;;2301;2356;4657
1284;CAPPELLE SUL TAVO;PE;;1985;2032;4017
1285;CAPRACOTTA;IS;;422;393;815
1286;CAPRAIA E LIMITE;FI;;3908;3973;7881
1287;CAPRAIA ISOLA;LI;;215;163;378
1288;CAPRALBA;CR;;1138;1129;2267
1289;CAPRANICA;VT;;3118;3259;6377
1290;CAPRANICA PRENESTINA;RM;;163;146;309
1291;CAPRARICA DI LECCE;LE;;1111;1211;2322
1292;CAPRAROLA;VT;;2584;2634;5218
1293;CAPRAUNA;CN;;54;42;96
1294;CAPRESE MICHELANGELO;AR;;658;697;1355
1295;CAPREZZO;VB;;92;79;171
1296;CAPRI;NA;;3358;3469;6827
1297;CAPRI LEONE;ME;;2096;2258;4354
1298;CAPRIANA;TN;;301;287;588
1299;CAPRIANO DEL COLLE;BS;;2374;2259;4633
1300;CAPRIATA D'ORBA;AL;;888;889;1777
1301;CAPRIATE SAN GERVASIO;BG;;4126;4064;8190
1302;CAPRIATI A VOLTURNO;CE;;696;773;1469
1303;CAPRIE;TO;;1042;1018;2060
1304;CAPRIGLIA IRPINA;AV;;1125;1138;2263
1305;CAPRIGLIO;AT;;168;138;306
1306;CAPRILE;BI;;104;92;196
1307;CAPRINO BERGAMASCO;BG;;1573;1466;3039
1308;CAPRINO VERONESE;VR;;4211;4393;8604
1309;CAPRIOLO;BS;;4717;4714;9431
1310;CAPRIVA DEL FRIULI;GO;;775;842;1617
1311;CAPUA;CE;;8582;9063;17645
1312;CAPURSO;BA;;7434;7841;15275
1313;CARAFFA DEL BIANCO;RC;;212;251;463
1314;CARAFFA DI CATANZARO;CZ;;868;871;1739
1315;CARAGLIO;CN;;3381;3374;6755
1316;CARAMAGNA PIEMONTE;CN;;1529;1543;3072
1317;CARAMANICO TERME;PE;;897;899;1796
1318;CARAPELLE;FG;;3382;3400;6782
1319;CARAPELLE CALVISIO;AQ;;41;37;78
1320;CARASCO;GE;;1841;1929;3770
1321;CARASSAI;AP;;482;499;981
1322;CARATE BRIANZA;MB;;8723;9065;17788
1323;CARATE URIO;CO;;535;566;1101
1324;CARAVAGGIO;BG;;7947;8162;16109
1325;CARAVATE;VA;;1285;1266;2551
1326;CARAVINO;TO;;450;451;901
1327;CARAVONICA;IM;;143;119;262
1328;CARBOGNANO;VT;;928;1006;1934
1329;CARBONARA AL TICINO;PV;;720;708;1428
1330;CARBONARA DI NOLA;NA;;1246;1236;2482
1331;CARBONARA SCRIVIA;AL;;547;557;1104
1332;CARBONATE;CO;;1456;1440;2896
1333;CARBONE;PZ;;266;275;541
1334;CARBONERA;TV;;5533;5744;11277
1335;CARBONIA;SU;;12720;13845;26565
1336;CARCARE;SV;;2482;2772;5254
1337;CARCOFORO;VC;;37;35;72
1338;CARDANO AL CAMPO;VA;;7243;7485;14728
1339;CARDE';CN;;560;583;1143
1340;CARDEDU;NU;;946;981;1927
1341;CARDETO;RC;;645;716;1361
1342;CARDINALE;CZ;;891;965;1856
1343;CARDITO;NA;;10636;10963;21599
1344;CAREGGINE;LU;;256;253;509
1345;CAREMA;TO;;347;392;739
1346;CARENNO;LC;;681;701;1382
1347;CARENTINO;AL;;165;156;321
1348;CARERI;RC;;1052;1083;2135
1349;CARESANA;VC;;585;472;1057
1350;CARESANABLOT;VC;;531;557;1088
1351;CAREZZANO;AL;;210;216;426
1352;CARFIZZI;KR;;246;278;524
1353;CARGEGHE;SS;;303;290;593
1354;CARIATI;CS;;3638;3838;7476
1355;CARIFE;AV;;630;659;1289
1356;CARIGNANO;TO;;4437;4615;9052
1357;CARIMATE;CO;;2209;2220;4429
1358;CARINARO;CE;;3483;3638;7121
1359;CARINI;PA;;19563;19712;39275
1360;CARINOLA;CE;;3650;3566;7216
1361;CARISIO;VC;;396;376;772
1362;CARISOLO;TN;;466;482;948
1363;CARLANTINO;FG;;398;428;826
1364;CARLAZZO;CO;;1505;1639;3144
1365;CARLENTINI;SR;;8335;8825;17160
1366;CARLINO;UD;;1313;1389;2702
1367;CARLOFORTE;SU;;2977;3006;5983
1368;CARLOPOLI;CZ;;705;701;1406
1369;CARMAGNOLA;TO;;13858;14455;28313
1370;CARMIANO;LE;;5746;5974;11720
1371;CARMIGNANO;PO;;7335;7418;14753
1372;CARMIGNANO DI BRENTA;PD;;3769;3709;7478
1373;CARNAGO;VA;;3256;3344;6600
1374;CARNATE;MB;;3806;3788;7594
1375;CAROBBIO DEGLI ANGELI;BG;;2440;2371;4811
1376;CAROLEI;CS;;1594;1561;3155
1377;CARONA;BG;;131;155;286
1378;CARONIA;ME;;1481;1612;3093
1379;CARONNO PERTUSELLA;VA;;8956;9160;18116
1380;CARONNO VARESINO;VA;;2377;2409;4786
1381;CAROSINO;TA;;3248;3415;6663
1382;CAROVIGNO;BR;;8473;8452;16925
1383;CAROVILLI;IS;;646;627;1273
1384;CARPANETO PIACENTINO;PC;;3782;3867;7649
1385;CARPANZANO;CS;;100;110;210
1386;CARPEGNA;PU;;807;827;1634
1387;CARPENEDOLO;BS;;6527;6450;12977
1388;CARPENETO;AL;;462;449;911
1389;CARPI;MO;;34848;36554;71402
1390;CARPIANO;MI;;2129;2021;4150
1391;CARPIGNANO SALENTINO;LE;;1833;1845;3678
1392;CARPIGNANO SESIA;NO;;1151;1319;2470
1393;CARPINETI;RE;;1919;1965;3884
1394;CARPINETO DELLA NORA;PE;;275;281;556
1395;CARPINETO ROMANO;RM;;1987;2107;4094
1396;CARPINETO SINELLO;CH;;269;261;530
1397;CARPINO;FG;;1932;1949;3881
1398;CARPINONE;IS;;503;539;1042
1399;CARRARA;MS;;29114;31071;60185
1400;CARRE';VI;;1731;1769;3500
1401;CARREGA LIGURE;AL;;52;36;88
1402;CARRO;SP;;245;269;514
1403;CARRODANO;SP;;247;230;477
1404;CARROSIO;AL;;261;233;494
1405;CARRU';CN;;2182;2200;4382
1406;CARSOLI;AQ;;2505;2562;5067
1407;CARTIGLIANO;VI;;1832;1879;3711
1408;CARTIGNANO;CN;;83;92;175
1409;CARTOCETO;PU;;3938;4028;7966
1410;CARTOSIO;AL;;349;371;720
1411;CARTURA;PD;;2258;2324;4582
1412;CARUGATE;MI;;7774;7890;15664
1413;CARUGO;CO;;3278;3291;6569
1414;CARUNCHIO;CH;;322;257;579
1415;CARVICO;BG;;2284;2362;4646
1416;CARZANO;TN;;259;259;518
1417;CASABONA;KR;;1128;1249;2377
1418;CASACALENDA;CB;;946;934;1880
1419;CASACANDITELLA;CH;;598;572;1170
1420;CASAGIOVE;CE;;6319;6797;13116
1421;CASAL CERMELLI;AL;;575;607;1182
1422;CASAL DI PRINCIPE;CE;;10628;10616;21244
1423;CASAL VELINO;SA;;2681;2662;5343
1424;CASALANGUIDA;CH;;395;442;837
1425;CASALATTICO;FR;;267;277;544
1426;CASALBELTRAME;NO;;499;492;991
1427;CASALBORDINO;CH;;2780;3050;5830
1428;CASALBORE;AV;;780;828;1608
1429;CASALBORGONE;TO;;906;949;1855
1430;CASALBUONO;SA;;528;537;1065
1431;CASALBUTTANO ED UNITI;CR;;1777;1875;3652
1432;CASALCIPRANO;CB;;229;241;470
1433;CASALDUNI;BN;;620;618;1238
1434;CASALE CORTE CERRO;VB;;1670;1715;3385
1435;CASALE CREMASCO-VIDOLASCO;CR;;946;883;1829
1436;CASALE DI SCODOSIA;PD;;2359;2342;4701
1437;CASALE LITTA;VA;;1359;1370;2729
1438;CASALE MARITTIMO;PI;;544;532;1076
1439;CASALE MONFERRATO;AL;;15392;17007;32399
1440;CASALE SUL SILE;TV;;6488;6672;13160
1441;CASALECCHIO DI RENO;BO;;16930;18854;35784
1442;CASALEGGIO BOIRO;AL;;186;184;370
1443;CASALEGGIO NOVARA;NO;;446;459;905
1444;CASALEONE;VR;;2771;2780;5551
1445;CASALETTO CEREDANO;CR;;582;569;1151
1446;CASALETTO DI SOPRA;CR;;271;244;515
1447;CASALETTO LODIGIANO;LO;;1489;1470;2959
1448;CASALETTO SPARTANO;SA;;627;676;1303
1449;CASALETTO VAPRIO;CR;;855;916;1771
1450;CASALFIUMANESE;BO;;1695;1672;3367
1451;CASALGRANDE;RE;;9436;9421;18857
1452;CASALGRASSO;CN;;717;695;1412
1453;CASALI DEL MANCO;CS;;4753;4843;9596
1454;CASALINCONTRADA;CH;;1489;1522;3011
1455;CASALINO;NO;;776;747;1523
1456;CASALMAGGIORE;CR;;7508;7466;14974
1457;CASALMAIOCCO;LO;;1572;1636;3208
1458;CASALMORANO;CR;;794;827;1621
1459;CASALMORO;MN;;1122;1086;2208
1460;CASALNOCETO;AL;;490;479;969
1461;CASALNUOVO DI NAPOLI;NA;;23135;24293;47428
1462;CASALNUOVO MONTEROTARO;FG;;686;693;1379
1463;CASALOLDO;MN;;1319;1335;2654
1464;CASALPUSTERLENGO;LO;;7650;7749;15399
1465;CASALROMANO;MN;;735;748;1483
1466;CASALSERUGO;PD;;2657;2733;5390
1467;CASALUCE;CE;;4697;4846;9543
1468;CASALVECCHIO DI PUGLIA;FG;;841;863;1704
1469;CASALVECCHIO SICULO;ME;;391;344;735
1470;CASALVIERI;FR;;1211;1227;2438
1471;CASALVOLONE;NO;;444;431;875
1472;CASALZUIGNO;VA;;671;691;1362
1473;CASAMARCIANO;NA;;1499;1549;3048
1474;CASAMASSIMA;BA;;9571;9833;19404
1475;CASAMICCIOLA TERME;NA;;3775;3940;7715
1476;CASANDRINO;NA;;6944;6419;13363
1477;CASANOVA ELVO;VC;;122;100;222
1478;CASANOVA LERRONE;SV;;365;372;737
1479;CASANOVA LONATI;PV;;239;214;453
1480;CASAPE;RM;;316;327;643
1481;CASAPESENNA;CE;;3362;3507;6869
1482;CASAPINTA;BI;;178;219;397
1483;CASAPROTA;RI;;340;351;691
1484;CASAPULLA;CE;;4091;4283;8374
1485;CASARANO;LE;;9203;10169;19372
1486;CASARGO;LC;;413;424;837
1487;CASARILE;MI;;1983;2037;4020
1488;CASARSA DELLA DELIZIA;PN;;4125;4115;8240
1489;CASARZA LIGURE;GE;;3331;3398;6729
1490;CASASCO;AL;;62;59;121
1491;CASATENOVO;LC;;6463;6720;13183
1492;CASATISMA;PV;;432;434;866
1493;CASAVATORE;NA;;8872;9410;18282
1494;CASAZZA;BG;;1900;1938;3838
1495;CASCIA;PG;;1477;1502;2979
1496;CASCIAGO;VA;;1758;1859;3617
1497;CASCIANA TERME LARI;PI;;6009;6151;12160
1498;CASCINA;PI;;21758;23107;44865
1499;CASCINETTE D'IVREA;TO;;744;780;1524
1500;CASEI GEROLA;PV;;1187;1192;2379
1501;CASELETTE;TO;;1507;1527;3034
1502;CASELLA;GE;;1589;1536;3125
1503;CASELLE IN PITTARI;SA;;917;947;1864
1504;CASELLE LANDI;LO;;760;737;1497
1505;CASELLE LURANI;LO;;1563;1475;3038
1506;CASELLE TORINESE;TO;;6839;6995;13834
1507;CASERTA;CE;;34445;38592;73037
1508;CASIER;TV;;5594;5762;11356
1509;CASIGNANA;RC;;340;367;707
1510;CASINA;RE;;2251;2259;4510
1511;CASIRATE D'ADDA;BG;;2043;2026;4069
1512;CASLINO D'ERBA;CO;;803;841;1644
1513;CASNATE CON BERNATE;CO;;2462;2549;5011
1514;CASNIGO;BG;;1554;1521;3075
1515;CASOLA DI NAPOLI;NA;;1782;1881;3663
1516;CASOLA IN LUNIGIANA;MS;;468;501;969
1517;CASOLA VALSENIO;RA;;1334;1207;2541
1518;CASOLE D'ELSA;SI;;1849;1867;3716
1519;CASOLI;CH;;2557;2673;5230
1520;CASORATE PRIMO;PV;;4396;4370;8766
1521;CASORATE SEMPIONE;VA;;2751;2920;5671
1522;CASOREZZO;MI;;2719;2816;5535
1523;CASORIA;NA;;36115;38279;74394
1524;CASORZO MONFERRATO;AT;;291;319;610
1525;CASPERIA;RI;;577;622;1199
1526;CASPOGGIO;SO;;662;680;1342
1527;CASSACCO;UD;;1389;1418;2807
1528;CASSAGO BRIANZA;LC;;2191;2179;4370
1529;CASSANO ALL'IONIO;CS;;8297;8282;16579
1530;CASSANO D'ADDA;MI;;9411;9783;19194
1531;CASSANO DELLE MURGE;BA;;7443;7527;14970
1532;CASSANO IRPINO;AV;;470;460;930
1533;CASSANO MAGNAGO;VA;;10479;10883;21362
1534;CASSANO SPINOLA;AL;;881;944;1825
1535;CASSANO VALCUVIA;VA;;327;343;670
1536;CASSARO;SR;;360;365;725
1537;CASSIGLIO;BG;;52;59;111
1538;CASSINA DE' PECCHI;MI;;6779;7162;13941
1539;CASSINA RIZZARDI;CO;;1604;1690;3294
1540;CASSINA VALSASSINA;LC;;271;258;529
1541;CASSINASCO;AT;;273;269;542
1542;CASSINE;AL;;1424;1397;2821
1543;CASSINELLE;AL;;444;408;852
1544;CASSINETTA DI LUGAGNANO;MI;;930;976;1906
1545;CASSINO;FR;;17405;17830;35235
1546;CASSOLA;VI;;7408;7682;15090
1547;CASSOLNOVO;PV;;3334;3428;6762
1548;CASTAGNARO;VR;;1777;1810;3587
1549;CASTAGNETO CARDUCCI;LI;;4327;4458;8785
1550;CASTAGNETO PO;TO;;897;866;1763
1551;CASTAGNITO;CN;;1079;1105;2184
1552;CASTAGNOLE DELLE LANZE;AT;;1777;1871;3648
1553;CASTAGNOLE MONFERRATO;AT;;586;566;1152
1554;CASTAGNOLE PIEMONTE;TO;;1090;1089;2179
1555;CASTANA;PV;;345;365;710
1556;CASTANO PRIMO;MI;;5427;5435;10862
1557;CASTEGGIO;PV;;3094;3396;6490
1558;CASTEGNATO;BS;;4170;4157;8327
1559;CASTEGNERO;VI;;1438;1411;2849
1560;CASTEL BARONIA;AV;;530;539;1069
1561;CASTEL BOGLIONE;AT;;311;261;572
1562;CASTEL BOLOGNESE;RA;;4738;4797;9535
1563;CASTEL CAMPAGNANO;CE;;702;771;1473
1564;CASTEL CASTAGNA;TE;;228;223;451
1565;CASTEL CONDINO;TN;;111;113;224
1566;CASTEL D'AIANO;BO;;972;914;1886
1567;CASTEL D'ARIO;MN;;2249;2345;4594
1568;CASTEL D'AZZANO;VR;;5955;6098;12053
1569;CASTEL DEL GIUDICE;IS;;169;153;322
1570;CASTEL DEL MONTE;AQ;;254;202;456
1571;CASTEL DEL PIANO;GR;;2407;2401;4808
1572;CASTEL DEL RIO;BO;;577;609;1186
1573;CASTEL DI CASIO;BO;;1644;1665;3309
1574;CASTEL DI IERI;AQ;;142;154;296
1575;CASTEL DI IUDICA;CT;;2098;2211;4309
1576;CASTEL DI LAMA;AP;;4174;4240;8414
1577;CASTEL DI LUCIO;ME;;579;605;1184
1578;CASTEL DI SANGRO;AQ;;3351;3192;6543
1579;CASTEL DI SASSO;CE;;527;549;1076
1580;CASTEL DI TORA;RI;;139;129;268
1581;CASTEL FOCOGNANO;AR;;1484;1479;2963
1582;CASTEL FRENTANO;CH;;2051;2211;4262
1583;CASTEL GABBIANO;CR;;244;214;458
1584;CASTEL GANDOLFO;RM;;4111;4541;8652
1585;CASTEL GIORGIO;TR;;959;1075;2034
1586;CASTEL GOFFREDO;MN;;6280;6268;12548
1587;CASTEL GUELFO DI BOLOGNA;BO;;2262;2254;4516
1588;CASTEL IVANO;TN;;1620;1640;3260
1589;CASTEL MADAMA;RM;;3545;3562;7107
1590;CASTEL MAGGIORE;BO;;8930;9570;18500
1591;CASTEL MELLA;BS;;5533;5460;10993
1592;CASTEL MORRONE;CE;;1750;1877;3627
1593;CASTEL RITALDI;PG;;1507;1541;3048
1594;CASTEL ROCCHERO;AT;;196;193;389
1595;CASTEL ROZZONE;BG;;1365;1408;2773
1596;CASTEL SAN GIORGIO;SA;;6780;6875;13655
1597;CASTEL SAN GIOVANNI;PC;;6937;7044;13981
1598;CASTEL SAN LORENZO;SA;;1085;1161;2246
1599;CASTEL SAN NICCOLO';AR;;1235;1282;2517
1600;CASTEL SAN PIETRO ROMANO;RM;;402;439;841
1601;CASTEL SAN PIETRO TERME;BO;;10121;10545;20666
1602;CASTEL SAN VINCENZO;IS;;233;228;461
1603;CASTEL SANT'ANGELO;RI;;603;592;1195
1604;CASTEL SANT'ELIA;VT;;1221;1250;2471
1605;CASTEL VISCARDO;TR;;1334;1397;2731
1606;CASTEL VITTORIO;IM;;139;122;261
1607;CASTEL VOLTURNO;CE;;14447;13357;27804
1608;CASTELBALDO;PD;;714;716;1430
1609;CASTELBELFORTE;MN;;1616;1615;3231
1610;CASTELBELLINO;AN;;2365;2563;4928
1611;CASTELBELLO-CIARDES/KASTELBELL-TSCHARS;BZ;;1181;1128;2309
1612;CASTELBIANCO;SV;;154;162;316
1613;CASTELBOTTACCIO;CB;;122;129;251
1614;CASTELBUONO;PA;;4013;4206;8219
1615;CASTELCIVITA;SA;;751;719;1470
1616;CASTELCOVATI;BS;;3446;3339;6785
1617;CASTELCUCCO;TV;;1153;1146;2299
1618;CASTELDACCIA;PA;;5755;5888;11643
1619;CASTELDELCI;RN;;181;189;370
1620;CASTELDELFINO;CN;;69;74;143
1621;CASTELDIDONE;CR;;298;271;569
1622;CASTELFIDARDO;AN;;9099;9369;18468
1623;CASTELFIORENTINO;FI;;8504;8860;17364
1624;CASTELFORTE;LT;;2018;2142;4160
1625;CASTELFRANCI;AV;;897;924;1821
1626;CASTELFRANCO DI SOTTO;PI;;6726;6734;13460
1627;CASTELFRANCO EMILIA;MO;;16701;16360;33061
1628;CASTELFRANCO IN MISCANO;BN;;411;408;819
1629;CASTELFRANCO PIANDISCO';AR;;4845;4987;9832
1630;CASTELFRANCO VENETO;TV;;16110;16946;33056
1631;CASTELGERUNDO;LO;;751;730;1481
1632;CASTELGOMBERTO;VI;;3106;3026;6132
1633;CASTELGRANDE;PZ;;422;403;825
1634;CASTELGUGLIELMO;RO;;770;744;1514
1635;CASTELGUIDONE;CH;;144;160;304
1636;CASTELL'ALFERO;AT;;1303;1334;2637
1637;CASTELL'ARQUATO;PC;;2250;2327;4577
1638;CASTELL'AZZARA;GR;;638;673;1311
1639;CASTELL'UMBERTO;ME;;1392;1486;2878
1640;CASTELLABATE;SA;;4311;4347;8658
1641;CASTELLAFIUME;AQ;;535;509;1044
1642;CASTELLALTO;TE;;3673;3665;7338
1643;CASTELLAMMARE DEL GOLFO;TP;;7304;7332;14636
1644;CASTELLAMMARE DI STABIA;NA;;30312;33018;63330
1645;CASTELLAMONTE;TO;;4787;4908;9695
1646;CASTELLANA GROTTE;BA;;9397;10004;19401
1647;CASTELLANA SICULA;PA;;1471;1618;3089
1648;CASTELLANETA;TA;;7978;8365;16343
1649;CASTELLANIA COPPI;AL;;48;40;88
1650;CASTELLANZA;VA;;6742;7335;14077
1651;CASTELLAR GUIDOBONO;AL;;202;196;398
1652;CASTELLARANO;RE;;7655;7664;15319
1653;CASTELLARO;IM;;620;647;1267
1654;CASTELLAZZO BORMIDA;AL;;2191;2244;4435
1655;CASTELLAZZO NOVARESE;NO;;159;157;316
1656;CASTELLEONE;CR;;4576;4694;9270
1657;CASTELLEONE DI SUASA;AN;;786;782;1568
1658;CASTELLERO;AT;;136;155;291
1659;CASTELLETTO CERVO;BI;;404;392;796
1660;CASTELLETTO D'ERRO;AL;;62;73;135
1661;CASTELLETTO D'ORBA;AL;;916;939;1855
1662;CASTELLETTO DI BRANDUZZO;PV;;500;489;989
1663;CASTELLETTO MERLI;AL;;234;218;452
1664;CASTELLETTO MOLINA;AT;;66;77;143
1665;CASTELLETTO MONFERRATO;AL;;726;717;1443
1666;CASTELLETTO SOPRA TICINO;NO;;4729;5097;9826
1667;CASTELLETTO STURA;CN;;681;668;1349
1668;CASTELLETTO UZZONE;CN;;159;151;310
1669;CASTELLI;TE;;497;500;997
1670;CASTELLI CALEPIO;BG;;5225;5173;10398
1671;CASTELLINA IN CHIANTI;SI;;1387;1290;2677
1672;CASTELLINA MARITTIMA;PI;;931;904;1835
1673;CASTELLINALDO D'ALBA;CN;;462;453;915
1674;CASTELLINO DEL BIFERNO;CB;;217;227;444
1675;CASTELLINO TANARO;CN;;142;139;281
1676;CASTELLIRI;FR;;1590;1612;3202
1677;CASTELLO CABIAGLIO;VA;;282;276;558
1678;CASTELLO D'AGOGNA;PV;;546;526;1072
1679;CASTELLO D'ARGILE;BO;;3317;3248;6565
1680;CASTELLO DEL MATESE;CE;;682;728;1410
1681;CASTELLO DELL'ACQUA;SO;;307;308;615
1682;CASTELLO DI ANNONE;AT;;947;862;1809
1683;CASTELLO DI BRIANZA;LC;;1314;1288;2602
1684;CASTELLO DI CISTERNA;NA;;3867;3948;7815
1685;CASTELLO DI GODEGO;TV;;3525;3587;7112
1686;CASTELLO TESINO;TN;;588;567;1155
1687;CASTELLO-MOLINA DI FIEMME;TN;;1164;1155;2319
1688;CASTELLUCCHIO;MN;;2605;2593;5198
1689;CASTELLUCCIO DEI SAURI;FG;;1038;1000;2038
1690;CASTELLUCCIO INFERIORE;PZ;;965;982;1947
1691;CASTELLUCCIO SUPERIORE;PZ;;366;365;731
1692;CASTELLUCCIO VALMAGGIORE;FG;;597;629;1226
1693;CASTELMAGNO;CN;;32;21;53
1694;CASTELMARTE;CO;;651;614;1265
1695;CASTELMASSA;RO;;1913;2084;3997
1696;CASTELMAURO;CB;;589;638;1227
1697;CASTELMEZZANO;PZ;;353;374;727
1698;CASTELMOLA;ME;;516;546;1062
1699;CASTELNOVETTO;PV;;256;269;525
1700;CASTELNOVO BARIANO;RO;;1300;1339;2639
1701;CASTELNOVO DEL FRIULI;PN;;419;412;831
1702;CASTELNOVO DI SOTTO;RE;;4132;4253;8385
1703;CASTELNOVO NE' MONTI;RE;;5060;5249;10309
1704;CASTELNUOVO;TN;;528;550;1078
1705;CASTELNUOVO BELBO;AT;;387;418;805
1706;CASTELNUOVO BERARDENGA;SI;;4373;4597;8970
1707;CASTELNUOVO BOCCA D'ADDA;LO;;763;779;1542
1708;CASTELNUOVO BORMIDA;AL;;296;316;612
1709;CASTELNUOVO BOZZENTE;CO;;440;463;903
1710;CASTELNUOVO CALCEA;AT;;363;329;692
1711;CASTELNUOVO CILENTO;SA;;1340;1462;2802
1712;CASTELNUOVO DEL GARDA;VR;;6587;6783;13370
1713;CASTELNUOVO DELLA DAUNIA;FG;;641;651;1292
1714;CASTELNUOVO DI CEVA;CN;;51;51;102
1715;CASTELNUOVO DI CONZA;SA;;304;291;595
1716;CASTELNUOVO DI FARFA;RI;;526;494;1020
1717;CASTELNUOVO DI GARFAGNANA;LU;;2733;2917;5650
1718;CASTELNUOVO DI PORTO;RM;;4248;4339;8587
1719;CASTELNUOVO DI VAL DI CECINA;PI;;1031;1063;2094
1720;CASTELNUOVO DON BOSCO;AT;;1531;1578;3109
1721;CASTELNUOVO MAGRA;SP;;4098;4263;8361
1722;CASTELNUOVO NIGRA;TO;;215;186;401
1723;CASTELNUOVO PARANO;FR;;422;436;858
1724;CASTELNUOVO RANGONE;MO;;7535;7505;15040
1725;CASTELNUOVO SCRIVIA;AL;;2378;2496;4874
1726;CASTELPAGANO;BN;;680;670;1350
1727;CASTELPETROSO;IS;;800;765;1565
1728;CASTELPIZZUTO;IS;;77;62;139
1729;CASTELPLANIO;AN;;1745;1770;3515
1730;CASTELPOTO;BN;;543;571;1114
1731;CASTELRAIMONDO;MC;;2124;2244;4368
1732;CASTELROTTO/KASTELRUTH;BZ;;3474;3417;6891
1733;CASTELSANTANGELO SUL NERA;MC;;127;105;232
1734;CASTELSARACENO;PZ;;577;620;1197
1735;CASTELSARDO;SS;;2843;2868;5711
1736;CASTELSEPRIO;VA;;643;666;1309
1737;CASTELSILANO;KR;;446;454;900
1738;CASTELSPINA;AL;;196;196;392
1739;CASTELTERMINI;AG;;3546;3838;7384
1740;CASTELVECCANA;VA;;925;942;1867
1741;CASTELVECCHIO CALVISIO;AQ;;54;70;124
1742;CASTELVECCHIO DI ROCCA BARBENA;SV;;72;61;133
1743;CASTELVECCHIO SUBEQUO;AQ;;398;447;845
1744;CASTELVENERE;BN;;1173;1253;2426
1745;CASTELVERDE;CR;;2777;2772;5549
1746;CASTELVERRINO;IS;;60;40;100
1747;CASTELVETERE IN VAL FORTORE;BN;;487;540;1027
1748;CASTELVETERE SUL CALORE;AV;;758;753;1511
1749;CASTELVETRANO;TP;;14420;15172;29592
1750;CASTELVETRO DI MODENA;MO;;5643;5515;11158
1751;CASTELVETRO PIACENTINO;PC;;2598;2644;5242
1752;CASTELVISCONTI;CR;;147;148;295
1753;CASTENASO;BO;;7637;8258;15895
1754;CASTENEDOLO;BS;;5767;5786;11553
1755;CASTIADAS;SU;;857;804;1661
1756;CASTIGLION FIBOCCHI;AR;;1066;1037;2103
1757;CASTIGLION FIORENTINO;AR;;6455;6597;13052
1758;CASTIGLIONE A CASAURIA;PE;;370;364;734
1759;CASTIGLIONE CHIAVARESE;GE;;751;829;1580
1760;CASTIGLIONE COSENTINO;CS;;1391;1261;2652
1761;CASTIGLIONE D'ADDA;LO;;2245;2250;4495
1762;CASTIGLIONE D'ORCIA;SI;;1040;1108;2148
1763;CASTIGLIONE DEI PEPOLI;BO;;2708;2655;5363
1764;CASTIGLIONE DEL GENOVESI;SA;;686;624;1310
1765;CASTIGLIONE DEL LAGO;PG;;7393;7800;15193
1766;CASTIGLIONE DELLA PESCAIA;GR;;3508;3590;7098
1767;CASTIGLIONE DELLE STIVIERE;MN;;11610;11703;23313
1768;CASTIGLIONE DI GARFAGNANA;LU;;860;847;1707
1769;CASTIGLIONE DI SICILIA;CT;;1440;1490;2930
1770;CASTIGLIONE FALLETTO;CN;;355;335;690
1771;CASTIGLIONE IN TEVERINA;VT;;1120;1161;2281
1772;CASTIGLIONE MESSER MARINO;CH;;737;808;1545
1773;CASTIGLIONE MESSER RAIMONDO;TE;;1044;1008;2052
1774;CASTIGLIONE OLONA;VA;;3772;3810;7582
1775;CASTIGLIONE TINELLA;CN;;400;411;811
1776;CASTIGLIONE TORINESE;TO;;3209;3260;6469
1777;CASTIGNANO;AP;;1278;1304;2582
1778;CASTILENTI;TE;;717;656;1373
1779;CASTINO;CN;;245;213;458
1780;CASTIONE ANDEVENNO;SO;;771;762;1533
1781;CASTIONE DELLA PRESOLANA;BG;;1683;1670;3353
1782;CASTIONS DI STRADA;UD;;1810;1884;3694
1783;CASTIRAGA VIDARDO;LO;;1500;1452;2952
1784;CASTO;BS;;840;785;1625
1785;CASTORANO;AP;;1096;1155;2251
1786;CASTREZZATO;BS;;3752;3742;7494
1787;CASTRI DI LECCE;LE;;1378;1411;2789
1788;CASTRIGNANO DE' GRECI;LE;;1796;1931;3727
1789;CASTRIGNANO DEL CAPO;LE;;2456;2687;5143
1790;CASTRO;BG;;613;619;1232
1791;CASTRO;LE;;1119;1246;2365
1792;CASTRO DEI VOLSCI;FR;;2199;2320;4519
1793;CASTROCARO TERME E TERRA DEL SOLE;FC;;3060;3212;6272
1794;CASTROCIELO;FR;;1863;1985;3848
1795;CASTROFILIPPO;AG;;1245;1400;2645
1796;CASTROLIBERO;CS;;4434;4862;9296
1797;CASTRONNO;VA;;2519;2520;5039
1798;CASTRONOVO DI SICILIA;PA;;1381;1484;2865
1799;CASTRONUOVO DI SANT'ANDREA;PZ;;444;485;929
1800;CASTROPIGNANO;CB;;419;455;874
1801;CASTROREALE;ME;;1100;1144;2244
1802;CASTROREGIO;CS;;134;105;239
1803;CASTROVILLARI;CS;;10080;10852;20932
1804;CATANIA;CT;;144999;156105;301104
1805;CATANZARO;CZ;;40854;44755;85609
1806;CATENANUOVA;EN;;2221;2325;4546
1807;CATIGNANO;PE;;625;611;1236
1808;CATTOLICA;RN;;7813;8756;16569
1809;CATTOLICA ERACLEA;AG;;1635;1690;3325
1810;CAULONIA;RC;;3289;3450;6739
1811;CAUTANO;BN;;994;956;1950
1812;CAVA DE' TIRRENI;SA;;24739;26328;51067
1813;CAVA MANARA;PV;;3213;3436;6649
1814;CAVAGLIA';BI;;1789;1757;3546
1815;CAVAGLIETTO;NO;;196;185;381
1816;CAVAGLIO D'AGOGNA;NO;;576;589;1165
1817;CAVAGNOLO;TO;;1102;1124;2226
1818;CAVAION VERONESE;VR;;2993;3074;6067
1819;CAVALESE;TN;;1948;2091;4039
1820;CAVALLERLEONE;CN;;350;323;673
1821;CAVALLERMAGGIORE;CN;;2657;2676;5333
1822;CAVALLINO;LE;;6224;6615;12839
1823;CAVALLINO-TREPORTI;VE;;6544;6840;13384
1824;CAVALLIRIO;NO;;652;655;1307
1825;CAVARENO;TN;;597;541;1138
1826;CAVARGNA;CO;;96;93;189
1827;CAVARIA CON PREMEZZO;VA;;2841;2797;5638
1828;CAVARZERE;VE;;6375;6587;12962
1829;CAVASO DEL TOMBA;TV;;1412;1460;2872
1830;CAVASSO NUOVO;PN;;741;760;1501
1831;CAVATORE;AL;;119;142;261
1832;CAVAZZO CARNICO;UD;;458;479;937
1833;CAVE;RM;;5386;5395;10781
1834;CAVEDAGO;TN;;298;265;563
1835;CAVEDINE;TN;;1536;1489;3025
1836;CAVENAGO D'ADDA;LO;;1042;1056;2098
1837;CAVENAGO DI BRIANZA;MB;;3685;3715;7400
1838;CAVERNAGO;BG;;1372;1348;2720
1839;CAVEZZO;MO;;3395;3602;6997
1840;CAVIZZANA;TN;;119;128;247
1841;CAVOUR;TO;;2667;2707;5374
1842;CAVRIAGO;RE;;4771;5064;9835
1843;CAVRIANA;MN;;1841;1906;3747
1844;CAVRIGLIA;AR;;4733;4729;9462
1845;CAZZAGO BRABBIA;VA;;405;397;802
1846;CAZZAGO SAN MARTINO;BS;;5323;5426;10749
1847;CAZZANO DI TRAMIGNA;VR;;743;765;1508
1848;CAZZANO SANT'ANDREA;BG;;828;812;1640
1849;CECCANO;FR;;10994;11507;22501
1850;CECIMA;PV;;127;117;244
1851;CECINA;LI;;13261;14637;27898
1852;CEDEGOLO;BS;;540;558;1098
1853;CEDRASCO;SO;;203;219;422
1854;CEFALA' DIANA;PA;;494;493;987
1855;CEFALU';PA;;6771;7187;13958
1856;CEGGIA;VE;;3048;3098;6146
1857;CEGLIE MESSAPICA;BR;;9040;9840;18880
1858;CELANO;AQ;;5277;5102;10379
1859;CELENZA SUL TRIGNO;CH;;392;410;802
1860;CELENZA VALFORTORE;FG;;669;734;1403
1861;CELICO;CS;;1288;1246;2534
1862;CELLA DATI;CR;;240;246;486
1863;CELLA MONTE;AL;;237;230;467
1864;CELLAMARE;BA;;2839;2959;5798
1865;CELLARA;CS;;243;237;480
1866;CELLARENGO;AT;;356;354;710
1867;CELLATICA;BS;;2332;2530;4862
1868;CELLE DI BULGHERIA;SA;;853;920;1773
1869;CELLE DI MACRA;CN;;51;33;84
1870;CELLE DI SAN VITO;FG;;73;74;147
1871;CELLE ENOMONDO;AT;;215;237;452
1872;CELLE LIGURE;SV;;2363;2547;4910
1873;CELLENO;VT;;657;665;1322
1874;CELLERE;VT;;551;524;1075
1875;CELLINO ATTANASIO;TE;;1136;1138;2274
1876;CELLINO SAN MARCO;BR;;2924;3246;6170
1877;CELLIO CON BREIA;VC;;466;474;940
1878;CELLOLE;CE;;3928;4158;8086
1879;CEMBRA LISIGNAGO;TN;;1181;1115;2296
1880;CENADI;CZ;;249;258;507
1881;CENATE SOPRA;BG;;1278;1237;2515
1882;CENATE SOTTO;BG;;1968;1960;3928
1883;CENCENIGHE AGORDINO;BL;;613;630;1243
1884;CENE;BG;;2043;2052;4095
1885;CENESELLI;RO;;770;782;1552
1886;CENGIO;SV;;1625;1668;3293
1887;CENTALLO;CN;;3519;3356;6875
1888;CENTO;FE;;17346;17882;35228
1889;CENTOLA;SA;;2585;2435;5020
1890;CENTRACHE;CZ;;170;170;340
1891;CENTRO VALLE INTELVI;CO;;1757;1816;3573
1892;CENTURIPE;EN;;2521;2608;5129
1893;CEPAGATTI;PE;;5384;5576;10960
1894;CEPPALONI;BN;;1597;1634;3231
1895;CEPPO MORELLI;VB;;156;145;301
1896;CEPRANO;FR;;4072;4188;8260
1897;CERAMI;EN;;911;956;1867
1898;CERANESI;GE;;1845;1792;3637
1899;CERANO;NO;;3291;3421;6712
1900;CERANO D'INTELVI;CO;;279;293;572
1901;CERANOVA;PV;;1147;1136;2283
1902;CERASO;SA;;1119;1149;2268
1903;CERCEMAGGIORE;CB;;1824;1770;3594
1904;CERCENASCO;TO;;872;910;1782
1905;CERCEPICCOLA;CB;;282;328;610
1906;CERCHIARA DI CALABRIA;CS;;1094;1090;2184
1907;CERCHIO;AQ;;780;789;1569
1908;CERCINO;SO;;397;385;782
1909;CERCIVENTO;UD;;323;329;652
1910;CERCOLA;NA;;8236;8888;17124
1911;CERDA;PA;;2436;2506;4942
1912;CEREA;VR;;8260;8491;16751
1913;CEREGNANO;RO;;1672;1768;3440
1914;CERENZIA;KR;;515;520;1035
1915;CERES;TO;;535;482;1017
1916;CERESARA;MN;;1301;1253;2554
1917;CERESETO;AL;;206;190;396
1918;CERESOLE ALBA;CN;;1021;985;2006
1919;CERESOLE REALE;TO;;86;73;159
1920;CERETE;BG;;784;813;1597
1921;CERETTO LOMELLINA;PV;;83;95;178
1922;CERGNAGO;PV;;336;345;681
1923;CERIALE;SV;;2611;2754;5365
1924;CERIANA;IM;;576;523;1099
1925;CERIANO LAGHETTO;MB;;3291;3354;6645
1926;CERIGNALE;PC;;67;50;117
1927;CERIGNOLA;FG;;28348;28779;57127
1928;CERISANO;CS;;1467;1472;2939
1929;CERMENATE;CO;;4567;4707;9274
1930;CERMES/TSCHERMS;BZ;;782;782;1564
1931;CERMIGNANO;TE;;716;743;1459
1932;CERNOBBIO;CO;;3085;3317;6402
1933;CERNUSCO LOMBARDONE;LC;;1860;1948;3808
1934;CERNUSCO SUL NAVIGLIO;MI;;16823;18146;34969
1935;CERRETO D'ASTI;AT;;115;107;222
1936;CERRETO D'ESI;AN;;1712;1703;3415
1937;CERRETO DI SPOLETO;PG;;481;504;985
1938;CERRETO GRUE;AL;;149;153;302
1939;CERRETO GUIDI;FI;;5262;5532;10794
1940;CERRETO LAZIALE;RM;;544;560;1104
1941;CERRETO SANNITA;BN;;1789;1841;3630
1942;CERRETTO LANGHE;CN;;217;185;402
1943;CERRINA MONFERRATO;AL;;643;666;1309
1944;CERRIONE;BI;;1369;1441;2810
1945;CERRO AL LAMBRO;MI;;2514;2576;5090
1946;CERRO AL VOLTURNO;IS;;590;565;1155
1947;CERRO MAGGIORE;MI;;7304;7680;14984
1948;CERRO TANARO;AT;;292;296;588
1949;CERRO VERONESE;VR;;1304;1277;2581
1950;CERSOSIMO;PZ;;264;277;541
1951;CERTALDO;FI;;7641;7842;15483
1952;CERTOSA DI PAVIA;PV;;2740;2715;5455
1953;CERVA;CZ;;521;585;1106
1954;CERVARA DI ROMA;RM;;242;199;441
1955;CERVARESE SANTA CROCE;PD;;2811;2841;5652
1956;CERVARO;FR;;3839;3973;7812
1957;CERVASCA;CN;;2613;2535;5148
1958;CERVATTO;VC;;32;18;50
1959;CERVENO;BS;;345;312;657
1960;CERVERE;CN;;1113;1142;2255
1961;CERVESINA;PV;;520;613;1133
1962;CERVETERI;RM;;18637;19104;37741
1963;CERVIA;RA;;13826;14932;28758
1964;CERVICATI;CS;;389;397;786
1965;CERVIGNANO D'ADDA;LO;;1091;1093;2184
1966;CERVIGNANO DEL FRIULI;UD;;6692;6854;13546
1967;CERVINARA;AV;;4275;4521;8796
1968;CERVINO;CE;;2353;2452;4805
1969;CERVO;IM;;533;585;1118
1970;CERZETO;CS;;614;614;1228
1971;CESA;CE;;4714;4730;9444
1972;CESANA BRIANZA;LC;;1179;1205;2384
1973;CESANA TORINESE;TO;;495;418;913
1974;CESANO BOSCONE;MI;;11435;12085;23520
1975;CESANO MADERNO;MB;;19483;19559;39042
1976;CESARA;VB;;287;310;597
1977;CESARO';ME;;1079;1125;2204
1978;CESATE;MI;;6971;7247;14218
1979;CESENA;FC;;46694;49474;96168
1980;CESENATICO;FC;;12576;13382;25958
1981;CESINALI;AV;;1279;1286;2565
1982;CESIO;IM;;150;123;273
1983;CESIOMAGGIORE;BL;;1987;1932;3919
1984;CESSALTO;TV;;1888;1888;3776
1985;CESSANITI;VV;;1502;1497;2999
1986;CESSAPALOMBO;MC;;202;237;439
1987;CESSOLE;AT;;182;180;362
1988;CETARA;SA;;998;999;1997
1989;CETO;BS;;889;899;1788
1990;CETONA;SI;;1199;1317;2516
1991;CETRARO;CS;;4702;4794;9496
1992;CEVA;CN;;2792;2849;5641
1993;CEVO;BS;;430;390;820
1994;CHALLAND-SAINT-ANSELME;AO;;369;373;742
1995;CHALLAND-SAINT-VICTOR;AO;;266;281;547
1996;CHAMBAVE;AO;;436;450;886
1997;CHAMOIS;AO;;60;49;109
1998;CHAMPDEPRAZ;AO;;338;379;717
1999;CHAMPORCHER;AO;;189;185;374
2000;CHARVENSOD;AO;;1158;1209;2367
2001;CHATILLON;AO;;2139;2263;4402
2002;CHERASCO;CN;;4668;4779;9447
2003;CHEREMULE;SS;;199;203;402
2004;CHIALAMBERTO;TO;;168;176;344
2005;CHIAMPO;VI;;6404;6130;12534
2006;CHIANCHE;AV;;243;225;468
2007;CHIANCIANO TERME;SI;;3309;3539;6848
2008;CHIANNI;PI;;660;655;1315
2009;CHIANOCCO;TO;;765;787;1552
2010;CHIARAMONTE GULFI;RG;;4069;3955;8024
2011;CHIARAMONTI;SS;;750;775;1525
2012;CHIARANO;TV;;1870;1795;3665
2013;CHIARAVALLE;AN;;6739;7567;14306
2014;CHIARAVALLE CENTRALE;CZ;;2432;2706;5138
2015;CHIARI;BS;;9522;9609;19131
2016;CHIAROMONTE;PZ;;855;910;1765
2017;CHIAUCI;IS;;110;96;206
2018;CHIAVARI;GE;;12593;14635;27228
2019;CHIAVENNA;SO;;3419;3816;7235
2020;CHIAVERANO;TO;;964;1021;1985
2021;CHIENES/KIENS;BZ;;1526;1460;2986
2022;CHIERI;TO;;17279;18637;35916
2023;CHIES D'ALPAGO;BL;;619;637;1256
2024;CHIESA IN VALMALENCO;SO;;1156;1194;2350
2025;CHIESANUOVA;TO;;120;111;231
2026;CHIESINA UZZANESE;PT;;2202;2266;4468
2027;CHIETI;CH;;23276;25390;48666
2028;CHIEUTI;FG;;772;791;1563
2029;CHIEVE;CR;;1120;1115;2235
2030;CHIGNOLO D'ISOLA;BG;;1744;1620;3364
2031;CHIGNOLO PO;PV;;1986;1946;3932
2032;CHIOGGIA;VE;;23774;24129;47903
2033;CHIOMONTE;TO;;426;444;870
2034;CHIONS;PN;;2522;2578;5100
2035;CHIOPRIS-VISCONE;UD;;328;354;682
2036;CHITIGNANO;AR;;426;440;866
2037;CHIUDUNO;BG;;3060;3007;6067
2038;CHIUPPANO;VI;;1245;1251;2496
2039;CHIURO;SO;;1152;1274;2426
2040;CHIUSA DI PESIO;CN;;1764;1784;3548
2041;CHIUSA DI SAN MICHELE;TO;;780;776;1556
2042;CHIUSA SCLAFANI;PA;;1208;1369;2577
2043;CHIUSA/KLAUSEN;BZ;;2609;2609;5218
2044;CHIUSAFORTE;UD;;323;291;614
2045;CHIUSANICO;IM;;313;280;593
2046;CHIUSANO D'ASTI;AT;;123;127;250
2047;CHIUSANO DI SAN DOMENICO;AV;;1030;1080;2110
2048;CHIUSAVECCHIA;IM;;261;252;513
2049;CHIUSDINO;SI;;871;896;1767
2050;CHIUSI;SI;;3923;4128;8051
2051;CHIUSI DELLA VERNA;AR;;939;950;1889
2052;CHIVASSO;TO;;12657;13618;26275
2053;CIAMPINO;RM;;18399;20120;38519
2054;CIANCIANA;AG;;1503;1656;3159
2055;CIBIANA DI CADORE;BL;;164;186;350
2056;CICAGNA;GE;;1149;1101;2250
2057;CICALA;CZ;;435;458;893
2058;CICCIANO;NA;;5990;6321;12311
2059;CICERALE;SA;;580;589;1169
2060;CICILIANO;RM;;644;611;1255
2061;CICOGNOLO;CR;;456;459;915
2062;CICONIO;TO;;188;176;364
2063;CIGLIANO;VC;;2085;2210;4295
2064;CIGLIE';CN;;91;92;183
2065;CIGOGNOLA;PV;;623;689;1312
2066;CIGOLE;BS;;710;731;1441
2067;CILAVEGNA;PV;;2616;2692;5308
2068;CIMADOLMO;TV;;1687;1656;3343
2069;CIMBERGO;BS;;277;266;543
2070;CIMINA';RC;;272;258;530
2071;CIMINNA;PA;;1678;1788;3466
2072;CIMITILE;NA;;3337;3603;6940
2073;CIMOLAIS;PN;;178;165;343
2074;CIMONE;TN;;376;346;722
2075;CINAGLIO;AT;;215;208;423
2076;CINETO ROMANO;RM;;278;297;575
2077;CINGIA DE' BOTTI;CR;;590;559;1149
2078;CINGOLI;MC;;4729;4950;9679
2079;CINIGIANO;GR;;1217;1173;2390
2080;CINISELLO BALSAMO;MI;;36512;37879;74391
2081;CINISI;PA;;5884;6057;11941
2082;CINO;SO;;175;158;333
2083;CINQUEFRONDI;RC;;3048;3221;6269
2084;CINTANO;TO;;125;115;240
2085;CINTE TESINO;TN;;173;165;338
2086;CINTO CAOMAGGIORE;VE;;1535;1579;3114
2087;CINTO EUGANEO;PD;;975;953;1928
2088;CINZANO;TO;;165;158;323
2089;CIORLANO;CE;;187;185;372
2090;CIPRESSA;IM;;578;603;1181
2091;CIRCELLO;BN;;1087;1096;2183
2092;CIRIE';TO;;8743;9469;18212
2093;CIRIGLIANO;MT;;129;161;290
2094;CIRIMIDO;CO;;1080;1041;2121
2095;CIRO';KR;;1204;1330;2534
2096;CIRO' MARINA;KR;;6831;7171;14002
2097;CIS;TN;;145;159;304
2098;CISANO BERGAMASCO;BG;;3061;3097;6158
2099;CISANO SUL NEVA;SV;;1050;1072;2122
2100;CISERANO;BG;;2849;2635;5484
2101;CISLAGO;VA;;5168;5245;10413
2102;CISLIANO;MI;;2506;2525;5031
2103;CISON DI VALMARINO;TV;;1249;1291;2540
2104;CISSONE;CN;;48;32;80
2105;CISTERNA D'ASTI;AT;;625;599;1224
2106;CISTERNA DI LATINA;LT;;18198;18338;36536
2107;CISTERNINO;BR;;5386;5845;11231
2108;CITERNA;PG;;1719;1709;3428
2109;CITTA' DELLA PIEVE;PG;;3596;3916;7512
2110;CITTA' DI CASTELLO;PG;;18508;19997;38505
2111;CITTA' SANT'ANGELO;PE;;7333;7466;14799
2112;CITTADELLA;PD;;9815;10261;20076
2113;CITTADUCALE;RI;;3163;3284;6447
2114;CITTANOVA;RC;;4784;5045;9829
2115;CITTAREALE;RI;;216;197;413
2116;CITTIGLIO;VA;;1880;1927;3807
2117;CIVATE;LC;;1845;1868;3713
2118;CIVEZZA;IM;;307;321;628
2119;CIVEZZANO;TN;;2055;2037;4092
2120;CIVIASCO;VC;;124;110;234
2121;CIVIDALE DEL FRIULI;UD;;5188;5687;10875
2122;CIVIDATE AL PIANO;BG;;2575;2461;5036
2123;CIVIDATE CAMUNO;BS;;1361;1294;2655
2124;CIVITA;CS;;393;429;822
2125;CIVITA CASTELLANA;VT;;7472;7944;15416
2126;CIVITA D'ANTINO;AQ;;453;465;918
2127;CIVITACAMPOMARANO;CB;;141;173;314
2128;CIVITALUPARELLA;CH;;153;139;292
2129;CIVITANOVA DEL SANNIO;IS;;445;445;890
2130;CIVITANOVA MARCHE;MC;;19954;21814;41768
2131;CIVITAQUANA;PE;;595;574;1169
2132;CIVITAVECCHIA;RM;;24964;26916;51880
2133;CIVITELLA ALFEDENA;AQ;;145;142;287
2134;CIVITELLA CASANOVA;PE;;791;814;1605
2135;CIVITELLA D'AGLIANO;VT;;741;752;1493
2136;CIVITELLA DEL TRONTO;TE;;2282;2319;4601
2137;CIVITELLA DI ROMAGNA;FC;;1799;1843;3642
2138;CIVITELLA IN VAL DI CHIANA;AR;;4384;4430;8814
2139;CIVITELLA MESSER RAIMONDO;CH;;393;397;790
2140;CIVITELLA PAGANICO;GR;;1520;1469;2989
2141;CIVITELLA ROVETO;AQ;;1564;1505;3069
2142;CIVITELLA SAN PAOLO;RM;;1000;989;1989
2143;CIVO;SO;;577;541;1118
2144;CLAINO CON OSTENO;CO;;281;258;539
2145;CLAUT;PN;;438;445;883
2146;CLAUZETTO;PN;;205;167;372
2147;CLAVESANA;CN;;387;412;799
2148;CLAVIERE;TO;;102;102;204
2149;CLES;TN;;3432;3721;7153
2150;CLETO;CS;;629;565;1194
2151;CLIVIO;VA;;934;1004;1938
2152;CLUSONE;BG;;4127;4383;8510
2153;COASSOLO TORINESE;TO;;729;715;1444
2154;COAZZE;TO;;1626;1592;3218
2155;COAZZOLO;AT;;150;143;293
2156;COCCAGLIO;BS;;4394;4334;8728
2157;COCCONATO;AT;;714;692;1406
2158;COCQUIO-TREVISAGO;VA;;2225;2398;4623
2159;COCULLO;AQ;;105;108;213
2160;CODEVIGO;PD;;3255;3081;6336
2161;CODEVILLA;PV;;450;492;942
2162;CODIGORO;FE;;5358;5821;11179
2163;CODOGNE';TV;;2659;2566;5225
2164;CODOGNO;LO;;7464;8026;15490
2165;CODROIPO;UD;;7837;8040;15877
2166;CODRONGIANOS;SS;;624;659;1283
2167;COGGIOLA;BI;;816;835;1651
2168;COGLIATE;MB;;4161;4298;8459
2169;COGNE;AO;;653;662;1315
2170;COGOLETO;GE;;4152;4451;8603
2171;COGOLLO DEL CENGIO;VI;;1569;1587;3156
2172;COGORNO;GE;;2823;2901;5724
2173;COLAZZA;NO;;276;254;530
2174;COLCERESA;VI;;2907;3004;5911
2175;COLERE;BG;;565;543;1108
2176;COLFELICE;FR;;883;930;1813
2177;COLI;PC;;430;402;832
2178;COLICO;LC;;3970;4024;7994
2179;COLLALTO SABINO;RI;;203;187;390
2180;COLLARMELE;AQ;;374;440;814
2181;COLLAZZONE;PG;;1624;1741;3365
2182;COLLE BRIANZA;LC;;912;861;1773
2183;COLLE D'ANCHISE;CB;;355;376;731
2184;COLLE DI TORA;RI;;197;165;362
2185;COLLE DI VAL D'ELSA;SI;;10537;11140;21677
2186;COLLE SAN MAGNO;FR;;319;317;636
2187;COLLE SANNITA;BN;;1082;1127;2209
2188;COLLE SANTA LUCIA;BL;;180;173;353
2189;COLLE UMBERTO;TV;;2489;2582;5071
2190;COLLEBEATO;BS;;2165;2314;4479
2191;COLLECCHIO;PR;;7201;7355;14556
2192;COLLECORVINO;PE;;2973;2988;5961
2193;COLLEDARA;TE;;1044;1053;2097
2194;COLLEDIMACINE;CH;;91;70;161
2195;COLLEDIMEZZO;CH;;223;216;439
2196;COLLEFERRO;RM;;9990;10674;20664
2197;COLLEGIOVE;RI;;71;59;130
2198;COLLEGNO;TO;;23290;25284;48574
2199;COLLELONGO;AQ;;569;553;1122
2200;COLLEPARDO;FR;;451;440;891
2201;COLLEPASSO;LE;;2758;2927;5685
2202;COLLEPIETRO;AQ;;97;103;200
2203;COLLERETTO CASTELNUOVO;TO;;155;157;312
2204;COLLERETTO GIACOSA;TO;;297;299;596
2205;COLLESALVETTI;LI;;7989;8381;16370
2206;COLLESANO;PA;;1766;1925;3691
2207;COLLETORTO;CB;;820;872;1692
2208;COLLEVECCHIO;RI;;781;767;1548
2209;COLLI A VOLTURNO;IS;;632;639;1271
2210;COLLI AL METAURO;PU;;6142;6093;12235
2211;COLLI DEL TRONTO;AP;;1787;1837;3624
2212;COLLI SUL VELINO;RI;;226;232;458
2213;COLLI VERDI;PV;;524;494;1018
2214;COLLIANO;SA;;1689;1766;3455
2215;COLLINAS;SU;;385;396;781
2216;COLLIO;BS;;1048;993;2041
2217;COLLOBIANO;VC;;40;46;86
2218;COLLOREDO DI MONTE ALBANO;UD;;1081;1111;2192
2219;COLMURANO;MC;;577;608;1185
2220;COLOBRARO;MT;;540;530;1070
2221;COLOGNA VENETA;VR;;4194;4229;8423
2222;COLOGNE;BS;;3766;3796;7562
2223;COLOGNO AL SERIO;BG;;5603;5462;11065
2224;COLOGNO MONZESE;MI;;22586;24047;46633
2225;COLOGNOLA AI COLLI;VR;;4397;4373;8770
2226;COLONNA;RM;;2051;2180;4231
2227;COLONNELLA;TE;;1812;1815;3627
2228;COLONNO;CO;;224;223;447
2229;COLORINA;SO;;717;673;1390
2230;COLORNO;PR;;4458;4500;8958
2231;COLOSIMI;CS;;569;589;1158
2232;COLTURANO;MI;;1032;1009;2041
2233;COLVERDE;CO;;2678;2773;5451
2234;COLZATE;BG;;810;810;1620
2235;COMABBIO;VA;;618;603;1221
2236;COMACCHIO;FE;;10860;11129;21989
2237;COMANO;MS;;326;336;662
2238;COMANO TERME;TN;;1440;1473;2913
2239;COMAZZO;LO;;1167;1092;2259
2240;COMEGLIANS;UD;;223;219;442
2241;COMELICO SUPERIORE;BL;;1025;1064;2089
2242;COMERIO;VA;;1354;1481;2835
2243;COMEZZANO-CIZZAGO;BS;;2064;1965;4029
2244;COMIGNAGO;NO;;610;599;1209
2245;COMISO;RG;;14882;15191;30073
2246;COMITINI;AG;;437;459;896
2247;COMIZIANO;NA;;831;867;1698
2248;COMMESSAGGIO;MN;;533;557;1090
2249;COMMEZZADURA;TN;;501;507;1008
2250;COMO;CO;;40411;42950;83361
2251;COMPIANO;PR;;543;524;1067
2252;COMUN NUOVO;BG;;2221;2150;4371
2253;COMUNANZA;AP;;1472;1471;2943
2254;CONA;VE;;1364;1424;2788
2255;CONCA CASALE;IS;;90;85;175
2256;CONCA DEI MARINI;SA;;349;325;674
2257;CONCA DELLA CAMPANIA;CE;;573;592;1165
2258;CONCAMARISE;VR;;548;526;1074
2259;CONCERVIANO;RI;;136;142;278
2260;CONCESIO;BS;;7706;7917;15623
2261;CONCORDIA SAGITTARIA;VE;;4976;5248;10224
2262;CONCORDIA SULLA SECCHIA;MO;;3985;4187;8172
2263;CONCOREZZO;MB;;7698;8065;15763
2264;CONDOFURI;RC;;2281;2396;4677
2265;CONDOVE;TO;;2168;2269;4437
2266;CONDRO';ME;;228;236;464
2267;CONEGLIANO;TV;;16463;17811;34274
2268;CONFIENZA;PV;;768;777;1545
2269;CONFIGNI;RI;;310;276;586
2270;CONFLENTI;CZ;;640;655;1295
2271;CONIOLO;AL;;230;215;445
2272;CONSELICE;RA;;4657;4834;9491
2273;CONSELVE;PD;;4892;5119;10011
2274;CONTA';TN;;691;710;1401
2275;CONTESSA ENTELLINA;PA;;752;777;1529
2276;CONTIGLIANO;RI;;1865;1824;3689
2277;CONTRADA;AV;;1512;1449;2961
2278;CONTROGUERRA;TE;;1105;1131;2236
2279;CONTRONE;SA;;403;388;791
2280;CONTURSI TERME;SA;;1612;1643;3255
2281;CONVERSANO;BA;;12705;13079;25784
2282;CONZA DELLA CAMPANIA;AV;;632;654;1286
2283;CONZANO;AL;;474;477;951
2284;COPERTINO;LE;;11244;11915;23159
2285;COPIANO;PV;;861;847;1708
2286;COPPARO;FE;;7523;8230;15753
2287;CORANA;PV;;381;384;765
2288;CORATO;BA;;23027;24090;47117
2289;CORBARA;SA;;1217;1292;2509
2290;CORBETTA;MI;;9235;9528;18763
2291;CORBOLA;RO;;1033;1138;2171
2292;CORCHIANO;VT;;1830;1764;3594
2293;CORCIANO;PG;;10356;11073;21429
2294;CORDENONS;PN;;8761;9125;17886
2295;CORDIGNANO;TV;;3376;3524;6900
2296;CORDOVADO;PN;;1323;1403;2726
2297;COREGLIA ANTELMINELLI;LU;;2511;2585;5096
2298;COREGLIA LIGURE;GE;;144;123;267
2299;CORENO AUSONIO;FR;;762;783;1545
2300;CORFINIO;AQ;;499;480;979
2301;CORI;LT;;5179;5277;10456
2302;CORIANO;RN;;5198;5243;10441
2303;CORIGLIANO D'OTRANTO;LE;;2714;2983;5697
2304;CORIGLIANO-ROSSANO;CS;;36534;37639;74173
2305;CORINALDO;AN;;2319;2478;4797
2306;CORIO;TO;;1511;1537;3048
2307;CORLEONE;PA;;5176;5317;10493
2308;CORLETO MONFORTE;SA;;257;266;523
2309;CORLETO PERTICARA;PZ;;1160;1168;2328
2310;CORMANO;MI;;9788;10539;20327
2311;CORMONS;GO;;3407;3791;7198
2312;CORNA IMAGNA;BG;;478;453;931
2313;CORNALBA;BG;;162;135;297
2314;CORNALE E BASTIDA;PV;;405;415;820
2315;CORNAREDO;MI;;10066;10510;20576
2316;CORNATE D'ADDA;MB;;5413;5371;10784
2317;CORNEDO ALL'ISARCO/KARNEID;BZ;;1736;1697;3433
2318;CORNEDO VICENTINO;VI;;5924;5784;11708
2319;CORNEGLIANO LAUDENSE;LO;;1383;1451;2834
2320;CORNELIANO D'ALBA;CN;;1051;1091;2142
2321;CORNIGLIO;PR;;891;849;1740
2322;CORNO DI ROSAZZO;UD;;1548;1570;3118
2323;CORNO GIOVINE;LO;;536;603;1139
2324;CORNOVECCHIO;LO;;109;98;207
2325;CORNUDA;TV;;3096;3190;6286
2326;CORREGGIO;RE;;12302;12706;25008
2327;CORREZZANA;MB;;1550;1564;3114
2328;CORREZZOLA;PD;;2546;2509;5055
2329;CORRIDO;CO;;422;425;847
2330;CORRIDONIA;MC;;7267;7554;14821
2331;CORROPOLI;TE;;2515;2593;5108
2332;CORSANO;LE;;2581;2618;5199
2333;CORSICO;MI;;16512;17926;34438
2334;CORSIONE;AT;;100;92;192
2335;CORTACCIA SULLA STRADA DEL VINO/KURTATSCH AN DER WEINSTRASSE;BZ;;1083;1101;2184
2336;CORTALE;CZ;;913;976;1889
2337;CORTANDONE;AT;;151;160;311
2338;CORTANZE;AT;;140;125;265
2339;CORTAZZONE;AT;;288;300;588
2340;CORTE BRUGNATELLA;PC;;264;271;535
2341;CORTE DE' CORTESI CON CIGNONE;CR;;543;518;1061
2342;CORTE DE' FRATI;CR;;671;640;1311
2343;CORTE FRANCA;BS;;3586;3561;7147
2344;CORTE PALASIO;LO;;783;746;1529
2345;CORTEMAGGIORE;PC;;2341;2269;4610
2346;CORTEMILIA;CN;;1061;1127;2188
2347;CORTENO GOLGI;BS;;963;959;1922
2348;CORTENOVA;LC;;568;579;1147
2349;CORTENUOVA;BG;;972;981;1953
2350;CORTEOLONA E GENZONE;PV;;1248;1286;2534
2351;CORTIGLIONE;AT;;269;267;536
2352;CORTINA D'AMPEZZO;BL;;2645;2982;5627
2353;CORTINA SULLA STRADA DEL VINO/KURTINIG AN DER WEINSTRASSE;BZ;;331;330;661
2354;CORTINO;TE;;325;276;601
2355;CORTONA;AR;;10301;11023;21324
2356;CORVARA;PE;;94;112;206
2357;CORVARA IN BADIA/CORVARA;BZ;;679;713;1392
2358;CORVINO SAN QUIRICO;PV;;465;507;972
2359;CORZANO;BS;;706;713;1419
2360;COSEANO;UD;;996;1049;2045
2361;COSENZA;CS;;30129;33944;64073
2362;COSIO D'ARROSCIA;IM;;81;94;175
2363;COSIO VALTELLINO;SO;;2745;2737;5482
2364;COSOLETO;RC;;391;404;795
2365;COSSANO BELBO;CN;;460;441;901
2366;COSSANO CANAVESE;TO;;220;220;440
2367;COSSATO;BI;;6682;7333;14015
2368;COSSERIA;SV;;521;532;1053
2369;COSSIGNANO;AP;;411;450;861
2370;COSSOGNO;VB;;346;322;668
2371;COSSOINE;SS;;383;382;765
2372;COSSOMBRATO;AT;;255;263;518
2373;COSTA DE' NOBILI;PV;;195;185;380
2374;COSTA DI MEZZATE;BG;;1692;1625;3317
2375;COSTA DI ROVIGO;RO;;1165;1283;2448
2376;COSTA MASNAGA;LC;;2392;2366;4758
2377;COSTA SERINA;BG;;443;423;866
2378;COSTA VALLE IMAGNA;BG;;278;269;547
2379;COSTA VESCOVATO;AL;;166;150;316
2380;COSTA VOLPINO;BG;;4379;4543;8922
2381;COSTABISSARA;VI;;3795;3861;7656
2382;COSTACCIARO;PG;;542;568;1110
2383;COSTANZANA;VC;;368;393;761
2384;COSTARAINERA;IM;;386;391;777
2385;COSTERMANO SUL GARDA;VR;;1976;1957;3933
2386;COSTIGLIOLE D'ASTI;AT;;2823;2856;5679
2387;COSTIGLIOLE SALUZZO;CN;;1689;1606;3295
2388;COTIGNOLA;RA;;3594;3759;7353
2389;COTRONEI;KR;;2565;2696;5261
2390;COTTANELLO;RI;;282;248;530
2391;COURMAYEUR;AO;;1306;1309;2615
2392;COVO;BG;;2149;2069;4218
2393;COZZO;PV;;186;169;355
2394;CRACO;MT;;325;319;644
2395;CRANDOLA VALSASSINA;LC;;142;127;269
2396;CRAVAGLIANA;VC;;144;124;268
2397;CRAVANZANA;CN;;183;194;377
2398;CRAVEGGIA;VB;;394;364;758
2399;CREAZZO;VI;;5480;5747;11227
2400;CRECCHIO;CH;;1314;1314;2628
2401;CREDARO;BG;;1790;1766;3556
2402;CREDERA RUBBIANO;CR;;777;774;1551
2403;CREMA;CR;;16396;17574;33970
2404;CREMELLA;LC;;828;851;1679
2405;CREMENAGA;VA;;365;410;775
2406;CREMENO;LC;;889;782;1671
2407;CREMIA;CO;;336;355;691
2408;CREMOLINO;AL;;507;505;1012
2409;CREMONA;CR;;34243;36598;70841
2410;CREMOSANO;CR;;884;841;1725
2411;CRESCENTINO;VC;;3837;3799;7636
2412;CRESPADORO;VI;;682;607;1289
2413;CRESPIATICA;LO;;1111;1081;2192
2414;CRESPINA LORENZANA;PI;;2699;2727;5426
2415;CRESPINO;RO;;837;896;1733
2416;CRESSA;NO;;783;821;1604
2417;CREVACUORE;BI;;666;724;1390
2418;CREVALCORE;BO;;6722;6876;13598
2419;CREVOLADOSSOLA;VB;;2202;2308;4510
2420;CRISPANO;NA;;5889;5995;11884
2421;CRISPIANO;TA;;6515;6716;13231
2422;CRISSOLO;CN;;88;68;156
2423;CROCEFIESCHI;GE;;287;235;522
2424;CROCETTA DEL MONTELLO;TV;;2991;3066;6057
2425;CRODO;VB;;705;714;1419
2426;CROGNALETO;TE;;622;497;1119
2427;CROPALATI;CS;;513;504;1017
2428;CROPANI;CZ;;2261;2396;4657
2429;CROSIA;CS;;4749;4881;9630
2430;CROSIO DELLA VALLE;VA;;316;285;601
2431;CROTONE;KR;;29352;30007;59359
2432;CROTTA D'ADDA;CR;;320;300;620
2433;CROVA;VC;;185;187;372
2434;CROVIANA;TN;;349;342;691
2435;CRUCOLI;KR;;1320;1461;2781
2436;CUASSO AL MONTE;VA;;1764;1810;3574
2437;CUCCARO VETERE;SA;;241;297;538
2438;CUCCIAGO;CO;;1729;1713;3442
2439;CUCEGLIO;TO;;466;464;930
2440;CUGGIONO;MI;;4023;4115;8138
2441;CUGLIATE-FABIASCO;VA;;1545;1525;3070
2442;CUGLIERI;OR;;1228;1259;2487
2443;CUGNOLI;PE;;666;684;1350
2444;CUMIANA;TO;;3921;3900;7821
2445;CUMIGNANO SUL NAVIGLIO;CR;;214;194;408
2446;CUNARDO;VA;;1430;1455;2885
2447;CUNEO;CN;;26777;28780;55557
2448;CUNICO;AT;;217;220;437
2449;CUORGNE';TO;;4631;4780;9411
2450;CUPELLO;CH;;2314;2434;4748
2451;CUPRA MARITTIMA;AP;;2620;2782;5402
2452;CUPRAMONTANA;AN;;2185;2235;4420
2453;CURA CARPIGNANO;PV;;2424;2491;4915
2454;CURCURIS;OR;;155;156;311
2455;CUREGGIO;NO;;1236;1340;2576
2456;CURIGLIA CON MONTEVIASCO;VA;;85;71;156
2457;CURINGA;CZ;;3201;3319;6520
2458;CURINO;BI;;219;244;463
2459;CURNO;BG;;3665;3788;7453
2460;CURON VENOSTA/GRAUN IM VINSCHGAU;BZ;;1219;1153;2372
2461;CURSI;LE;;1905;1986;3891
2462;CURTAROLO;PD;;3529;3609;7138
2463;CURTATONE;MN;;7116;7595;14711
2464;CURTI;CE;;3174;3524;6698
2465;CUSAGO;MI;;2199;2203;4402
2466;CUSANO MILANINO;MI;;8997;9872;18869
2467;CUSANO MUTRI;BN;;1927;1895;3822
2468;CUSINO;CO;;114;104;218
2469;CUSIO;BG;;112;98;210
2470;CUSTONACI;TP;;2649;2657;5306
2471;CUTRO;KR;;4697;4781;9478
2472;CUTROFIANO;LE;;4168;4553;8721
2473;CUVEGLIO;VA;;1582;1664;3246
2474;CUVIO;VA;;786;845;1631
2475;DAIRAGO;MI;;3119;3253;6372
2476;DALMINE;BG;;11543;11698;23241
2477;DAMBEL;TN;;213;203;416
2478;DANTA DI CADORE;BL;;220;218;438
2479;DARFO BOARIO TERME;BS;;7715;7831;15546
2480;DASA';VV;;548;565;1113
2481;DAVAGNA;GE;;973;884;1857
2482;DAVERIO;VA;;1495;1590;3085
2483;DAVOLI;CZ;;2721;2760;5481
2484;DAZIO;SO;;226;256;482
2485;DECIMOMANNU;CA;;4203;4133;8336
2486;DECIMOPUTZU;SU;;2130;2075;4205
2487;DECOLLATURA;CZ;;1462;1458;2920
2488;DEGO;SV;;907;949;1856
2489;DEIVA MARINA;SP;;622;670;1292
2490;DELEBIO;SO;;1696;1635;3331
2491;DELIA;CL;;1852;2051;3903
2492;DELIANUOVA;RC;;1490;1635;3125
2493;DELICETO;FG;;1770;1793;3563
2494;DELLO;BS;;2816;2762;5578
2495;DEMONTE;CN;;954;899;1853
2496;DENICE;AL;;83;88;171
2497;DENNO;TN;;621;591;1212
2498;DERNICE;AL;;88;92;180
2499;DEROVERE;CR;;150;136;286
2500;DERUTA;PG;;4635;4809;9444
2501;DERVIO;LC;;1276;1310;2586
2502;DESANA;VC;;510;553;1063
2503;DESENZANO DEL GARDA;BS;;13804;15289;29093
2504;DESIO;MB;;20470;21198;41668
2505;DESULO;NU;;1066;1083;2149
2506;DIAMANTE;CS;;2456;2628;5084
2507;DIANO ARENTINO;IM;;342;343;685
2508;DIANO CASTELLO;IM;;1100;1160;2260
2509;DIANO D'ALBA;CN;;1817;1805;3622
2510;DIANO MARINA;IM;;2623;3005;5628
2511;DIANO SAN PIETRO;IM;;544;554;1098
2512;DICOMANO;FI;;2784;2659;5443
2513;DIGNANO;UD;;1096;1166;2262
2514;DIMARO FOLGARIDA;TN;;1003;1078;2081
2515;DINAMI;VV;;900;928;1828
2516;DIPIGNANO;CS;;2016;2106;4122
2517;DISO;LE;;1354;1498;2852
2518;DIVIGNANO;NO;;708;725;1433
2519;DIZZASCO;CO;;313;323;636
2520;DOBBIACO/TOBLACH;BZ;;1699;1656;3355
2521;DOBERDO' DEL LAGO;GO;;648;702;1350
2522;DOGLIANI;CN;;2278;2275;4553
2523;DOGLIOLA;CH;;163;148;311
2524;DOGNA;UD;;81;73;154
2525;DOLCE';VR;;1234;1268;2502
2526;DOLCEACQUA;IM;;1036;1109;2145
2527;DOLCEDO;IM;;637;636;1273
2528;DOLEGNA DEL COLLIO;GO;;168;149;317
2529;DOLIANOVA;SU;;4761;4735;9496
2530;DOLO;VE;;7279;7662;14941
2531;DOLZAGO;LC;;1248;1270;2518
2532;DOMANICO;CS;;442;462;904
2533;DOMASO;CO;;719;732;1451
2534;DOMEGGE DI CADORE;BL;;1080;1178;2258
2535;DOMICELLA;AV;;937;901;1838
2536;DOMODOSSOLA;VB;;8385;9299;17684
2537;DOMUS DE MARIA;SU;;832;796;1628
2538;DOMUSNOVAS;SU;;2914;3008;5922
2539;DONATO;BI;;356;354;710
2540;DONGO;CO;;1569;1664;3233
2541;DONNAS;AO;;1164;1225;2389
2542;DONORI;SU;;1004;972;1976
2543;DORGALI;NU;;4211;4157;8368
2544;DORIO;LC;;152;169;321
2545;DORMELLETTO;NO;;1236;1325;2561
2546;DORNO;PV;;2254;2274;4528
2547;DORZANO;BI;;270;258;528
2548;DOSOLO;MN;;1627;1636;3263
2549;DOSSENA;BG;;460;422;882
2550;DOSSO DEL LIRO;CO;;114;122;236
2551;DOUES;AO;;246;256;502
2552;DOVADOLA;FC;;744;819;1563
2553;DOVERA;CR;;1873;1889;3762
2554;DOZZA;BO;;3206;3327;6533
2555;DRAGONI;CE;;936;1051;1987
2556;DRAPIA;VV;;1007;1055;2062
2557;DRENA;TN;;297;290;587
2558;DRENCHIA;UD;;48;51;99
2559;DRESANO;MI;;1497;1538;3035
2560;DRO;TN;;2490;2540;5030
2561;DRONERO;CN;;3404;3498;6902
2562;DRUENTO;TO;;4379;4594;8973
2563;DRUOGNO;VB;;522;528;1050
2564;DUALCHI;NU;;284;292;576
2565;DUBINO;SO;;1881;1871;3752
2566;DUE CARRARE;PD;;4484;4479;8963
2567;DUEVILLE;VI;;6703;7011;13714
2568;DUGENTA;BN;;1262;1372;2634
2569;DUINO AURISINA;TS;;4031;4322;8353
2570;DUMENZA;VA;;746;715;1461
2571;DUNO;VA;;85;59;144
2572;DURAZZANO;BN;;1066;1066;2132
2573;DURONIA;CB;;209;188;397
2574;DUSINO SAN MICHELE;AT;;560;528;1088
2575;EBOLI;SA;;19052;18542;37594
2576;EDOLO;BS;;2164;2247;4411
2577;EGNA/NEUMARKT;BZ;;2658;2775;5433
2578;ELICE;PE;;819;820;1639
2579;ELINI;NU;;279;280;559
2580;ELLO;LC;;573;634;1207
2581;ELMAS;CA;;4667;4757;9424
2582;ELVA;CN;;44;38;82
2583;EMARESE;AO;;110;110;220
2584;EMPOLI;FI;;23416;24981;48397
2585;ENDINE GAIANO;BG;;1693;1686;3379
2586;ENEGO;VI;;793;761;1554
2587;ENEMONZO;UD;;632;648;1280
2588;ENNA;EN;;12298;13517;25815
2589;ENTRACQUE;CN;;395;375;770
2590;ENTRATICO;BG;;1007;985;1992
2591;ENVIE;CN;;993;961;1954
2592;EPISCOPIA;PZ;;631;649;1280
2593;ERACLEA;VE;;5965;6041;12006
2594;ERBA;CO;;7780;8311;16091
2595;ERBE';VR;;935;951;1886
2596;ERBEZZO;VR;;431;366;797
2597;ERBUSCO;BS;;4400;4268;8668
2598;ERCHIE;BR;;4034;4252;8286
2599;ERCOLANO;NA;;24612;25968;50580
2600;ERICE;TP;;12753;13682;26435
2601;ERLI;SV;;114;101;215
2602;ERTO E CASSO;PN;;185;188;373
2603;ERULA;SS;;349;342;691
2604;ERVE;LC;;339;347;686
2605;ESANATOGLIA;MC;;901;1015;1916
2606;ESCALAPLANO;SU;;1109;983;2092
2607;ESCOLCA;SU;;258;285;543
2608;ESINE;BS;;2545;2573;5118
2609;ESINO LARIO;LC;;378;384;762
2610;ESPERIA;FR;;1788;1789;3577
2611;ESPORLATU;SS;;184;198;382
2612;ESTE;PD;;7651;8324;15975
2613;ESTERZILI;SU;;272;293;565
2614;ETROUBLES;AO;;251;221;472
2615;EUPILIO;CO;;1272;1303;2575
2616;EXILLES;TO;;124;117;241
2617;FABBRICA CURONE;AL;;285;301;586
2618;FABBRICHE DI VERGEMOLI;LU;;358;357;715
2619;FABBRICO;RE;;3318;3292;6610
2620;FABRIANO;AN;;14044;15026;29070
2621;FABRICA DI ROMA;VT;;4029;4104;8133
2622;FABRIZIA;VV;;964;1039;2003
2623;FABRO;TR;;1284;1342;2626
2624;FAEDIS;UD;;1386;1389;2775
2625;FAEDO VALTELLINO;SO;;259;244;503
2626;FAENZA;RA;;28946;29953;58899
2627;FAETO;FG;;305;301;606
2628;FAGAGNA;UD;;2961;3049;6010
2629;FAGGETO LARIO;CO;;583;565;1148
2630;FAGGIANO;TA;;1677;1746;3423
2631;FAGNANO ALTO;AQ;;188;187;375
2632;FAGNANO CASTELLO;CS;;1694;1779;3473
2633;FAGNANO OLONA;VA;;6141;6292;12433
2634;FAI DELLA PAGANELLA;TN;;443;462;905
2635;FAICCHIO;BN;;1669;1701;3370
2636;FALCADE;BL;;877;947;1824
2637;FALCIANO DEL MASSICO;CE;;1610;1752;3362
2638;FALCONARA ALBANESE;CS;;701;726;1427
2639;FALCONARA MARITTIMA;AN;;12371;13205;25576
2640;FALCONE;ME;;1349;1436;2785
2641;FALERIA;VT;;992;1005;1997
2642;FALERNA;CZ;;1901;1858;3759
2643;FALERONE;FM;;1591;1551;3142
2644;FALLO;CH;;65;59;124
2645;FALOPPIO;CO;;2394;2437;4831
2646;FALVATERRA;FR;;258;258;516
2647;FALZES/PFALZEN;BZ;;1493;1484;2977
2648;FANANO;MO;;1441;1500;2941
2649;FANNA;PN;;729;751;1480
2650;FANO;PU;;28814;31112;59926
2651;FANO ADRIANO;TE;;142;115;257
2652;FARA FILIORUM PETRI;CH;;981;990;1971
2653;FARA GERA D'ADDA;BG;;3962;4015;7977
2654;FARA IN SABINA;RI;;6848;7000;13848
2655;FARA NOVARESE;NO;;986;1021;2007
2656;FARA OLIVANA CON SOLA;BG;;684;628;1312
2657;FARA SAN MARTINO;CH;;644;650;1294
2658;FARA VICENTINO;VI;;1849;1872;3721
2659;FARDELLA;PZ;;292;283;575
2660;FARIGLIANO;CN;;838;860;1698
2661;FARINDOLA;PE;;663;694;1357
2662;FARINI;PC;;536;542;1078
2663;FARNESE;VT;;670;712;1382
2664;FARRA D'ISONZO;GO;;822;849;1671
2665;FARRA DI SOLIGO;TV;;4189;4319;8508
2666;FASANO;BR;;19011;19932;38943
2667;FASCIA;GE;;37;36;73
2668;FAUGLIA;PI;;1829;1845;3674
2669;FAULE;CN;;227;237;464
2670;FAVALE DI MALVARO;GE;;217;216;433
2671;FAVARA;AG;;15476;16437;31913
2672;FAVIGNANA;TP;;2281;2187;4468
2673;FAVRIA;TO;;2552;2563;5115
2674;FEISOGLIO;CN;;142;153;295
2675;FELETTO;TO;;1088;1102;2190
2676;FELINO;PR;;4530;4620;9150
2677;FELITTO;SA;;549;614;1163
2678;FELIZZANO;AL;;1052;1079;2131
2679;FELTRE;BL;;9860;10591;20451
2680;FENEGRO';CO;;1636;1594;3230
2681;FENESTRELLE;TO;;248;233;481
2682;FERENTILLO;TR;;901;921;1822
2683;FERENTINO;FR;;10088;10074;20162
2684;FERLA;SR;;1137;1188;2325
2685;FERMIGNANO;PU;;4089;4150;8239
2686;FERMO;FM;;17394;18529;35923
2687;FERNO;VA;;3313;3372;6685
2688;FEROLETO ANTICO;CZ;;979;1011;1990
2689;FEROLETO DELLA CHIESA;RC;;745;775;1520
2690;FERRANDINA;MT;;4017;4072;8089
2691;FERRARA;FE;;61762;68110;129872
2692;FERRARA DI MONTE BALDO;VR;;134;125;259
2693;FERRAZZANO;CB;;1575;1622;3197
2694;FERRERA DI VARESE;VA;;354;346;700
2695;FERRERA ERBOGNONE;PV;;547;518;1065
2696;FERRERE;AT;;753;746;1499
2697;FERRIERE;PC;;602;514;1116
2698;FERRUZZANO;RC;;362;414;776
2699;FIAMIGNANO;RI;;636;569;1205
2700;FIANO;TO;;1331;1348;2679
2701;FIANO ROMANO;RM;;8095;7932;16027
2702;FIASTRA;MC;;322;299;621
2703;FIAVE';TN;;511;557;1068
2704;FICARAZZI;PA;;6334;6565;12899
2705;FICAROLO;RO;;1076;1114;2190
2706;FICARRA;ME;;632;684;1316
2707;FICULLE;TR;;784;800;1584
2708;FIDENZA;PR;;13134;13847;26981
2709;FIE' ALLO SCILIAR/VOLS AM SCHLERN;BZ;;1796;1831;3627
2710;FIEROZZO;TN;;252;218;470
2711;FIESCO;CR;;589;611;1200
2712;FIESOLE;FI;;6618;7109;13727
2713;FIESSE;BS;;1003;1000;2003
2714;FIESSO D'ARTICO;VE;;4159;4263;8422
2715;FIESSO UMBERTIANO;RO;;1896;1973;3869
2716;FIGINO SERENZA;CO;;2434;2534;4968
2717;FIGLINE E INCISA VALDARNO;FI;;11238;11981;23219
2718;FIGLINE VEGLIATURO;CS;;546;567;1113
2719;FILACCIANO;RM;;232;240;472
2720;FILADELFIA;VV;;2422;2526;4948
2721;FILAGO;BG;;1546;1562;3108
2722;FILANDARI;VV;;867;904;1771
2723;FILATTIERA;MS;;1085;1125;2210
2724;FILETTINO;FR;;269;248;517
2725;FILETTO;CH;;435;443;878
2726;FILIANO;PZ;;1369;1399;2768
2727;FILIGHERA;PV;;399;416;815
2728;FILIGNANO;IS;;299;287;586
2729;FILOGASO;VV;;680;657;1337
2730;FILOTTRANO;AN;;4447;4539;8986
2731;FINALE EMILIA;MO;;7400;7578;14978
2732;FINALE LIGURE;SV;;5322;5835;11157
2733;FINO DEL MONTE;BG;;595;560;1155
2734;FINO MORNASCO;CO;;4904;4925;9829
2735;FIORANO AL SERIO;BG;;1432;1529;2961
2736;FIORANO CANAVESE;TO;;363;372;735
2737;FIORANO MODENESE;MO;;8361;8509;16870
2738;FIORENZUOLA D'ARDA;PC;;7284;7574;14858
2739;FIRENZE;FI;;170671;190948;361619
2740;FIRENZUOLA;FI;;2204;2232;4436
2741;FIRMO;CS;;938;942;1880
2742;FISCAGLIA;FE;;4120;4265;8385
2743;FISCIANO;SA;;6885;6974;13859
2744;FIUGGI;FR;;4909;5211;10120
2745;FIUMALBO;MO;;594;586;1180
2746;FIUMARA;RC;;411;438;849
2747;FIUME VENETO;PN;;5737;6002;11739
2748;FIUMEDINISI;ME;;642;646;1288
2749;FIUMEFREDDO BRUZIO;CS;;1388;1411;2799
2750;FIUMEFREDDO DI SICILIA;CT;;4335;4793;9128
2751;FIUMICELLO VILLA VICENTINA;UD;;3102;3197;6299
2752;FIUMICINO;RM;;40292;40446;80738
2753;FIUMINATA;MC;;627;648;1275
2754;FIVIZZANO;MS;;3524;3666;7190
2755;FLAIBANO;UD;;555;540;1095
2756;FLERO;BS;;4382;4426;8808
2757;FLORESTA;ME;;233;237;470
2758;FLORIDIA;SR;;10550;10921;21471
2759;FLORINAS;SS;;715;731;1446
2760;FLUMERI;AV;;1220;1307;2527
2761;FLUMINIMAGGIORE;SU;;1325;1356;2681
2762;FLUSSIO;OR;;191;235;426
2763;FOBELLO;VC;;108;78;186
2764;FOGGIA;FG;;72103;74700;146803
2765;FOGLIANISE;BN;;1543;1641;3184
2766;FOGLIANO REDIPUGLIA;GO;;1436;1556;2992
2767;FOGLIZZO;TO;;1099;1166;2265
2768;FOIANO DELLA CHIANA;AR;;4482;4701;9183
2769;FOIANO DI VAL FORTORE;BN;;647;689;1336
2770;FOLGARIA;TN;;1526;1621;3147
2771;FOLIGNANO;AP;;4392;4480;8872
2772;FOLIGNO;PG;;26494;29009;55503
2773;FOLLINA;TV;;1756;1878;3634
2774;FOLLO;SP;;3054;3079;6133
2775;FOLLONICA;GR;;9716;10891;20607
2776;FOMBIO;LO;;1154;1085;2239
2777;FONDACHELLI-FANTINA;ME;;519;424;943
2778;FONDI;LT;;19748;19759;39507
2779;FONNI;NU;;1786;1906;3692
2780;FONTAINEMORE;AO;;221;204;425
2781;FONTANA LIRI;FR;;1350;1402;2752
2782;FONTANAFREDDA;PN;;6334;6428;12762
2783;FONTANAROSA;AV;;1414;1472;2886
2784;FONTANELICE;BO;;976;955;1931
2785;FONTANELLA;BG;;2388;2334;4722
2786;FONTANELLATO;PR;;3489;3516;7005
2787;FONTANELLE;TV;;2810;2847;5657
2788;FONTANETO D'AGOGNA;NO;;1283;1309;2592
2789;FONTANETTO PO;VC;;526;527;1053
2790;FONTANIGORDA;GE;;129;115;244
2791;FONTANILE;AT;;241;252;493
2792;FONTANIVA;PD;;3983;3982;7965
2793;FONTE;TV;;3082;2984;6066
2794;FONTE NUOVA;RM;;16028;16463;32491
2795;FONTECCHIO;AQ;;136;153;289
2796;FONTECHIARI;FR;;589;667;1256
2797;FONTEGRECA;CE;;386;374;760
2798;FONTENO;BG;;287;280;567
2799;FONTEVIVO;PR;;2806;2771;5577
2800;FONZASO;BL;;1522;1531;3053
2801;FOPPOLO;BG;;98;70;168
2802;FORANO;RI;;1554;1524;3078
2803;FORCE;AP;;585;574;1159
2804;FORCHIA;BN;;610;590;1200
2805;FORCOLA;SO;;383;382;765
2806;FORDONGIANUS;OR;;410;440;850
2807;FORENZA;PZ;;950;925;1875
2808;FORESTO SPARSO;BG;;1559;1494;3053
2809;FORGARIA NEL FRIULI;UD;;861;847;1708
2810;FORINO;AV;;2583;2594;5177
2811;FORIO;NA;;8716;8740;17456
2812;FORLI';FC;;56620;59938;116558
2813;FORLI' DEL SANNIO;IS;;313;320;633
2814;FORLIMPOPOLI;FC;;6427;6686;13113
2815;FORMAZZA;VB;;227;215;442
2816;FORMELLO;RM;;6516;6965;13481
2817;FORMIA;LT;;17922;19356;37278
2818;FORMICOLA;CE;;682;723;1405
2819;FORMIGARA;CR;;494;507;1001
2820;FORMIGINE;MO;;17059;17435;34494
2821;FORMIGLIANA;VC;;252;245;497
2822;FORNACE;TN;;673;640;1313
2823;FORNELLI;IS;;892;899;1791
2824;FORNI AVOLTRI;UD;;256;259;515
2825;FORNI DI SOPRA;UD;;468;455;923
2826;FORNI DI SOTTO;UD;;278;270;548
2827;FORNO CANAVESE;TO;;1622;1608;3230
2828;FORNOVO DI TARO;PR;;2861;3002;5863
2829;FORNOVO SAN GIOVANNI;BG;;1690;1696;3386
2830;FORTE DEI MARMI;LU;;3205;3738;6943
2831;FORTEZZA/FRANZENSFESTE;BZ;;543;518;1061
2832;FORTUNAGO;PV;;184;164;348
2833;FORZA D'AGRO';ME;;419;429;848
2834;FOSCIANDORA;LU;;269;290;559
2835;FOSDINOVO;MS;;2258;2339;4597
2836;FOSSA;AQ;;344;354;698
2837;FOSSACESIA;CH;;3085;3159;6244
2838;FOSSALTA DI PIAVE;VE;;2035;2112;4147
2839;FOSSALTA DI PORTOGRUARO;VE;;2808;2984;5792
2840;FOSSALTO;CB;;568;610;1178
2841;FOSSANO;CN;;12136;12106;24242
2842;FOSSATO DI VICO;PG;;1316;1336;2652
2843;FOSSATO SERRALTA;CZ;;281;293;574
2844;FOSSO';VE;;3457;3594;7051
2845;FOSSOMBRONE;PU;;4516;4580;9096
2846;FOZA;VI;;347;314;661
2847;FRABOSA SOPRANA;CN;;380;339;719
2848;FRABOSA SOTTANA;CN;;868;736;1604
2849;FRACONALTO;AL;;163;140;303
2850;FRAGAGNANO;TA;;2397;2602;4999
2851;FRAGNETO L'ABATE;BN;;468;515;983
2852;FRAGNETO MONFORTE;BN;;820;869;1689
2853;FRAINE;CH;;127;147;274
2854;FRAMURA;SP;;303;296;599
2855;FRANCAVILLA AL MARE;CH;;12274;13449;25723
2856;FRANCAVILLA ANGITOLA;VV;;901;906;1807
2857;FRANCAVILLA BISIO;AL;;255;251;506
2858;FRANCAVILLA D'ETE;FM;;481;455;936
2859;FRANCAVILLA DI SICILIA;ME;;1715;1876;3591
2860;FRANCAVILLA FONTANA;BR;;17091;18155;35246
2861;FRANCAVILLA IN SINNI;PZ;;1977;2008;3985
2862;FRANCAVILLA MARITTIMA;CS;;1360;1418;2778
2863;FRANCICA;VV;;800;778;1578
2864;FRANCOFONTE;SR;;5821;6067;11888
2865;FRANCOLISE;CE;;2314;2309;4623
2866;FRASCARO;AL;;214;235;449
2867;FRASCAROLO;PV;;526;562;1088
2868;FRASCATI;RM;;10845;11860;22705
2869;FRASCINETO;CS;;916;1011;1927
2870;FRASSILONGO;TN;;173;165;338
2871;FRASSINELLE POLESINE;RO;;673;671;1344
2872;FRASSINELLO MONFERRATO;AL;;225;245;470
2873;FRASSINETO PO;AL;;666;696;1362
2874;FRASSINETTO;TO;;160;119;279
2875;FRASSINO;CN;;142;120;262
2876;FRASSINORO;MO;;877;877;1754
2877;FRASSO SABINO;RI;;369;367;736
2878;FRASSO TELESINO;BN;;1011;1036;2047
2879;FRATTA POLESINE;RO;;1172;1329;2501
2880;FRATTA TODINA;PG;;904;941;1845
2881;FRATTAMAGGIORE;NA;;13896;14825;28721
2882;FRATTAMINORE;NA;;7690;7890;15580
2883;FRATTE ROSA;PU;;422;437;859
2884;FRAZZANO';ME;;295;299;594
2885;FREGONA;TV;;1393;1422;2815
2886;FRESAGRANDINARIA;CH;;437;462;899
2887;FRESONARA;AL;;324;299;623
2888;FRIGENTO;AV;;1734;1727;3461
2889;FRIGNANO;CE;;4464;4546;9010
2890;FRINCO;AT;;380;382;762
2891;FRISA;CH;;813;813;1626
2892;FRISANCO;PN;;285;274;559
2893;FRONT;TO;;816;797;1613
2894;FRONTINO;PU;;141;144;285
2895;FRONTONE;PU;;587;617;1204
2896;FROSINONE;FR;;20931;22899;43830
2897;FROSOLONE;IS;;1474;1415;2889
2898;FROSSASCO;TO;;1376;1423;2799
2899;FRUGAROLO;AL;;909;984;1893
2900;FUBINE MONFERRATO;AL;;765;812;1577
2901;FUCECCHIO;FI;;11206;11558;22764
2902;FUIPIANO VALLE IMAGNA;BG;;103;105;208
2903;FUMANE;VR;;2123;1983;4106
2904;FUMONE;FR;;980;1017;1997
2905;FUNES/VILLNOSS;BZ;;1273;1272;2545
2906;FURCI;CH;;384;436;820
2907;FURCI SICULO;ME;;1566;1655;3221
2908;FURNARI;ME;;1916;1935;3851
2909;FURORE;SA;;372;328;700
2910;FURTEI;SU;;768;757;1525
2911;FUSCALDO;CS;;3913;3914;7827
2912;FUSIGNANO;RA;;3996;4079;8075
2913;FUSINE;SO;;278;275;553
2914;FUTANI;SA;;502;598;1100
2915;FENIS;AO;;872;916;1788
2916;GABBIONETA BINANUOVA;CR;;430;429;859
2917;GABIANO;AL;;525;497;1022
2918;GABICCE MARE;PU;;2703;2837;5540
2919;GABY;AO;;219;205;424
2920;GADESCO PIEVE DELMONA;CR;;946;943;1889
2921;GADONI;NU;;338;365;703
2922;GAETA;LT;;9423;10175;19598
2923;GAGGI;ME;;1530;1586;3116
2924;GAGGIANO;MI;;4493;4725;9218
2925;GAGGIO MONTANO;BO;;2370;2427;4797
2926;GAGLIANICO;BI;;1740;2001;3741
2927;GAGLIANO ATERNO;AQ;;118;118;236
2928;GAGLIANO CASTELFERRATO;EN;;1592;1752;3344
2929;GAGLIANO DEL CAPO;LE;;2370;2524;4894
2930;GAGLIATO;CZ;;211;229;440
2931;GAGLIOLE;MC;;272;251;523
2932;GAIARINE;TV;;3006;3019;6025
2933;GAIBA;RO;;470;500;970
2934;GAIOLA;CN;;298;276;574
2935;GAIOLE IN CHIANTI;SI;;1295;1289;2584
2936;GAIRO;NU;;652;652;1304
2937;GAIS/GAIS;BZ;;1667;1563;3230
2938;GALATI MAMERTINO;ME;;1067;1261;2328
2939;GALATINA;LE;;12438;13447;25885
2940;GALATONE;LE;;7266;7829;15095
2941;GALATRO;RC;;697;756;1453
2942;GALBIATE;LC;;4138;4320;8458
2943;GALEATA;FC;;1222;1216;2438
2944;GALGAGNANO;LO;;671;639;1310
2945;GALLARATE;VA;;25626;26826;52452
2946;GALLESE;VT;;1270;1353;2623
2947;GALLIATE;NO;;7587;7964;15551
2948;GALLIATE LOMBARDO;VA;;479;510;989
2949;GALLIAVOLA;PV;;79;92;171
2950;GALLICANO;LU;;1813;1800;3613
2951;GALLICANO NEL LAZIO;RM;;3283;3217;6500
2952;GALLICCHIO;PZ;;434;379;813
2953;GALLIERA;BO;;2765;2764;5529
2954;GALLIERA VENETA;PD;;3532;3573;7105
2955;GALLINARO;FR;;590;630;1220
2956;GALLIO;VI;;1156;1186;2342
2957;GALLIPOLI;LE;;9493;10068;19561
2958;GALLO MATESE;CE;;245;249;494
2959;GALLODORO;ME;;160;176;336
2960;GALLUCCIO;CE;;1006;1035;2041
2961;GALTELLI';NU;;1181;1203;2384
2962;GALZIGNANO TERME;PD;;2134;2167;4301
2963;GAMALERO;AL;;383;434;817
2964;GAMBARA;BS;;2296;2253;4549
2965;GAMBARANA;PV;;96;104;200
2966;GAMBASCA;CN;;182;165;347
2967;GAMBASSI TERME;FI;;2346;2445;4791
2968;GAMBATESA;CB;;625;658;1283
2969;GAMBELLARA;VI;;1689;1710;3399
2970;GAMBERALE;CH;;139;142;281
2971;GAMBETTOLA;FC;;5175;5484;10659
2972;GAMBOLO';PV;;4788;4909;9697
2973;GANDELLINO;BG;;507;458;965
2974;GANDINO;BG;;2553;2621;5174
2975;GANDOSSO;BG;;744;701;1445
2976;GANGI;PA;;2960;3219;6179
2977;GARAGUSO;MT;;498;496;994
2978;GARBAGNA;AL;;301;314;615
2979;GARBAGNA NOVARESE;NO;;704;701;1405
2980;GARBAGNATE MILANESE;MI;;13026;13766;26792
2981;GARBAGNATE MONASTERO;LC;;1304;1229;2533
2982;GARDA;VR;;2037;2105;4142
2983;GARDONE RIVIERA;BS;;1295;1313;2608
2984;GARDONE VAL TROMPIA;BS;;5653;5699;11352
2985;GARESSIO;CN;;1399;1482;2881
2986;GARGALLO;NO;;870;894;1764
2987;GARGAZZONE/GARGAZON;BZ;;882;929;1811
2988;GARGNANO;BS;;1311;1420;2731
2989;GARLASCO;PV;;4592;4864;9456
2990;GARLATE;LC;;1335;1331;2666
2991;GARLENDA;SV;;673;675;1348
2992;GARNIGA TERME;TN;;208;183;391
2993;GARZENO;CO;;338;338;676
2994;GARZIGLIANA;TO;;264;266;530
2995;GASPERINA;CZ;;949;959;1908
2996;GASSINO TORINESE;TO;;4516;4845;9361
2997;GATTATICO;RE;;2899;2813;5712
2998;GATTEO;FC;;4671;4649;9320
2999;GATTICO-VERUNO;NO;;2542;2682;5224
3000;GATTINARA;VC;;3694;3917;7611
3001;GAVARDO;BS;;6188;6010;12198
3002;GAVELLO;RO;;745;706;1451
3003;GAVERINA TERME;BG;;451;417;868
3004;GAVI;AL;;2200;2244;4444
3005;GAVIGNANO;RM;;973;955;1928
3006;GAVIRATE;VA;;4367;4769;9136
3007;GAVOI;NU;;1237;1260;2497
3008;GAVORRANO;GR;;4061;4131;8192
3009;GAZOLDO DEGLI IPPOLITI;MN;;1531;1476;3007
3010;GAZZADA SCHIANNO;VA;;2224;2335;4559
3011;GAZZANIGA;BG;;2383;2545;4928
3012;GAZZO;PD;;2150;2141;4291
3013;GAZZO VERONESE;VR;;2576;2602;5178
3014;GAZZOLA;PC;;1081;1015;2096
3015;GAZZUOLO;MN;;1024;1063;2087
3016;GELA;CL;;35175;36762;71937
3017;GEMMANO;RN;;561;560;1121
3018;GEMONA DEL FRIULI;UD;;5080;5464;10544
3019;GEMONIO;VA;;1416;1431;2847
3020;GENAZZANO;RM;;2813;2798;5611
3021;GENGA;AN;;823;841;1664
3022;GENIVOLTA;CR;;567;560;1127
3023;GENOLA;CN;;1311;1276;2587
3024;GENONI;SU;;384;387;771
3025;GENOVA;GE;;266949;294254;561203
3026;GENURI;SU;;149;165;314
3027;GENZANO DI LUCANIA;PZ;;2637;2666;5303
3028;GENZANO DI ROMA;RM;;11207;11851;23058
3029;GERA LARIO;CO;;534;520;1054
3030;GERACE;RC;;1202;1197;2399
3031;GERACI SICULO;PA;;850;870;1720
3032;GERANO;RM;;584;573;1157
3033;GERENZAGO;PV;;716;708;1424
3034;GERENZANO;VA;;5262;5489;10751
3035;GERGEI;SU;;582;555;1137
3036;GERMAGNANO;TO;;572;548;1120
3037;GERMAGNO;VB;;99;82;181
3038;GERMIGNAGA;VA;;1818;1925;3743
3039;GEROCARNE;VV;;976;960;1936
3040;GEROLA ALTA;SO;;98;63;161
3041;GERRE DE' CAPRIOLI;CR;;658;648;1306
3042;GESICO;SU;;387;384;771
3043;GESSATE;MI;;4368;4423;8791
3044;GESSOPALENA;CH;;593;641;1234
3045;GESTURI;SU;;570;594;1164
3046;GESUALDO;AV;;1618;1656;3274
3047;GHEDI;BS;;9360;9158;18518
3048;GHEMME;NO;;1657;1729;3386
3049;GHIFFA;VB;;1145;1149;2294
3050;GHILARZA;OR;;2035;2206;4241
3051;GHISALBA;BG;;3088;3069;6157
3052;GHISLARENGO;VC;;414;402;816
3053;GIACCIANO CON BARUCHELLA;RO;;1028;1015;2043
3054;GIAGLIONE;TO;;283;309;592
3055;GIANICO;BS;;1038;1083;2121
3056;GIANO DELL'UMBRIA;PG;;1845;1809;3654
3057;GIANO VETUSTO;CE;;316;339;655
3058;GIARDINELLO;PA;;1154;1139;2293
3059;GIARDINI NAXOS;ME;;4336;4812;9148
3060;GIAROLE;AL;;312;359;671
3061;GIARRATANA;RG;;1369;1434;2803
3062;GIARRE;CT;;12901;13784;26685
3063;GIAVE;SS;;253;241;494
3064;GIAVENO;TO;;7942;8272;16214
3065;GIAVERA DEL MONTELLO;TV;;2596;2569;5165
3066;GIBA;SU;;930;989;1919
3067;GIBELLINA;TP;;1791;2010;3801
3068;GIFFLENGA;BI;;55;49;104
3069;GIFFONE;RC;;794;821;1615
3070;GIFFONI SEI CASALI;SA;;2500;2487;4987
3071;GIFFONI VALLE PIANA;SA;;5729;5873;11602
3072;GIGNESE;VB;;547;508;1055
3073;GIGNOD;AO;;849;850;1699
3074;GILDONE;CB;;368;387;755
3075;GIMIGLIANO;CZ;;1500;1535;3035
3076;GINESTRA;PZ;;360;349;709
3077;GINESTRA DEGLI SCHIAVONI;BN;;213;204;417
3078;GINOSA;TA;;10909;10960;21869
3079;GIOI;SA;;530;597;1127
3080;GIOIA DEI MARSI;AQ;;892;813;1705
3081;GIOIA DEL COLLE;BA;;13094;13637;26731
3082;GIOIA SANNITICA;CE;;1661;1696;3357
3083;GIOIA TAURO;RC;;9578;9676;19254
3084;GIOIOSA IONICA;RC;;3375;3490;6865
3085;GIOIOSA MAREA;ME;;3274;3463;6737
3086;GIOVE;TR;;899;947;1846
3087;GIOVINAZZO;BA;;9429;10056;19485
3088;GIOVO;TN;;1287;1233;2520
3089;GIRASOLE;NU;;660;675;1335
3090;GIRIFALCO;CZ;;2752;2871;5623
3091;GISSI;CH;;1228;1289;2517
3092;GIUGGIANELLO;LE;;555;586;1141
3093;GIUGLIANO IN CAMPANIA;NA;;61423;62335;123758
3094;GIULIANA;PA;;870;861;1731
3095;GIULIANO DI ROMA;FR;;1168;1180;2348
3096;GIULIANO TEATINO;CH;;574;561;1135
3097;GIULIANOVA;TE;;11160;12282;23442
3098;GIUNGANO;SA;;646;654;1300
3099;GIURDIGNANO;LE;;968;978;1946
3100;GIUSSAGO;PV;;2653;2592;5245
3101;GIUSSANO;MB;;12958;13057;26015
3102;GIUSTENICE;SV;;493;500;993
3103;GIUSTINO;TN;;357;384;741
3104;GIUSVALLA;SV;;208;193;401
3105;GIVOLETTO;TO;;2067;2028;4095
3106;GIZZERIA;CZ;;2604;2393;4997
3107;GLORENZA/GLURNS;BZ;;472;452;924
3108;GODEGA DI SANT'URBANO;TV;;2940;3002;5942
3109;GODIASCO SALICE TERME;PV;;1523;1669;3192
3110;GODRANO;PA;;528;535;1063
3111;GOITO;MN;;4992;5071;10063
3112;GOLASECCA;VA;;1318;1336;2654
3113;GOLFERENZO;PV;;96;79;175
3114;GOLFO ARANCI;SS;;1145;1231;2376
3115;GOMBITO;CR;;329;288;617
3116;GONARS;UD;;2229;2325;4554
3117;GONI;SU;;250;205;455
3118;GONNESA;SU;;2335;2362;4697
3119;GONNOSCODINA;OR;;238;198;436
3120;GONNOSFANADIGA;SU;;3029;3214;6243
3121;GONNOSNO';OR;;352;360;712
3122;GONNOSTRAMATZA;OR;;394;415;809
3123;GONZAGA;MN;;4384;4279;8663
3124;GORDONA;SO;;967;969;1936
3125;GORGA;RM;;346;343;689
3126;GORGO AL MONTICANO;TV;;2053;1960;4013
3127;GORGOGLIONE;MT;;441;429;870
3128;GORGONZOLA;MI;;10169;10780;20949
3129;GORIANO SICOLI;AQ;;265;245;510
3130;GORIZIA;GO;;16373;17242;33615
3131;GORLA MAGGIORE;VA;;2426;2446;4872
3132;GORLA MINORE;VA;;4046;4048;8094
3133;GORLAGO;BG;;2556;2563;5119
3134;GORLE;BG;;3180;3393;6573
3135;GORNATE OLONA;VA;;1102;1077;2179
3136;GORNO;BG;;756;742;1498
3137;GORO;FE;;1694;1839;3533
3138;GORRETO;GE;;48;46;94
3139;GORZEGNO;CN;;132;123;255
3140;GOSALDO;BL;;276;263;539
3141;GOSSOLENGO;PC;;2835;2876;5711
3142;GOTTASECCA;CN;;65;65;130
3143;GOTTOLENGO;BS;;2444;2513;4957
3144;GOVONE;CN;;1091;1164;2255
3145;GOZZANO;NO;;2746;2741;5487
3146;GRADARA;PU;;2487;2432;4919
3147;GRADISCA D'ISONZO;GO;;3030;3340;6370
3148;GRADO;GO;;3727;4062;7789
3149;GRADOLI;VT;;638;642;1280
3150;GRAFFIGNANA;LO;;1297;1281;2578
3151;GRAFFIGNANO;VT;;1042;1078;2120
3152;GRAGLIA;BI;;716;750;1466
3153;GRAGNANO;NA;;13819;14348;28167
3154;GRAGNANO TREBBIENSE;PC;;2252;2286;4538
3155;GRAMMICHELE;CT;;6129;6437;12566
3156;GRANA MONFERRATO;AT;;246;277;523
3157;GRANAROLO DELL'EMILIA;BO;;6189;6389;12578
3158;GRANDATE;CO;;1355;1459;2814
3159;GRANDOLA ED UNITI;CO;;663;654;1317
3160;GRANITI;ME;;735;714;1449
3161;GRANOZZO CON MONTICELLO;NO;;667;665;1332
3162;GRANTOLA;VA;;598;639;1237
3163;GRANTORTO;PD;;2273;2238;4511
3164;GRANZE;PD;;944;1004;1948
3165;GRASSANO;MT;;2399;2389;4788
3166;GRASSOBBIO;BG;;3255;3181;6436
3167;GRATTERI;PA;;437;436;873
3168;GRAVEDONA ED UNITI;CO;;1988;2097;4085
3169;GRAVELLONA LOMELLINA;PV;;1339;1372;2711
3170;GRAVELLONA TOCE;VB;;3694;3977;7671
3171;GRAVERE;TO;;346;320;666
3172;GRAVINA DI CATANIA;CT;;11966;13190;25156
3173;GRAVINA IN PUGLIA;BA;;21298;21617;42915
3174;GRAZZANISE;CE;;3355;3386;6741
3175;GRAZZANO BADOGLIO;AT;;289;288;577
3176;GRECCIO;RI;;753;761;1514
3177;GRECI;AV;;290;301;591
3178;GREGGIO;VC;;171;157;328
3179;GREMIASCO;AL;;149;143;292
3180;GRESSAN;AO;;1678;1712;3390
3181;GRESSONEY-LA-TRINITE';AO;;157;175;332
3182;GRESSONEY-SAINT-JEAN;AO;;397;402;799
3183;GREVE IN CHIANTI;FI;;6542;6785;13327
3184;GREZZAGO;MI;;1571;1500;3071
3185;GREZZANA;VR;;5396;5321;10717
3186;GRIANTE;CO;;295;296;591
3187;GRICIGNANO DI AVERSA;CE;;6319;6309;12628
3188;GRIGNASCO;NO;;2106;2239;4345
3189;GRIGNO;TN;;1002;1028;2030
3190;GRIMACCO;UD;;140;153;293
3191;GRIMALDI;CS;;770;766;1536
3192;GRINZANE CAVOUR;CN;;989;998;1987
3193;GRISIGNANO DI ZOCCO;VI;;2115;2162;4277
3194;GRISOLIA;CS;;1095;1134;2229
3195;GRIZZANA MORANDI;BO;;1971;1912;3883
3196;GROGNARDO;AL;;119;102;221
3197;GROMO;BG;;599;535;1134
3198;GRONDONA;AL;;228;248;476
3199;GRONE;BG;;446;419;865
3200;GRONTARDO;CR;;754;735;1489
3201;GROPELLO CAIROLI;PV;;2076;2166;4242
3202;GROPPARELLO;PC;;1076;1051;2127
3203;GROSCAVALLO;TO;;98;93;191
3204;GROSIO;SO;;2098;2273;4371
3205;GROSOTTO;SO;;806;831;1637
3206;GROSSETO;GR;;39175;42328;81503
3207;GROSSO;TO;;475;512;987
3208;GROTTAFERRATA;RM;;9575;10880;20455
3209;GROTTAGLIE;TA;;14929;15940;30869
3210;GROTTAMINARDA;AV;;3802;3931;7733
3211;GROTTAMMARE;AP;;7646;8279;15925
3212;GROTTAZZOLINA;FM;;1572;1642;3214
3213;GROTTE;AG;;2504;2794;5298
3214;GROTTE DI CASTRO;VT;;1248;1194;2442
3215;GROTTERIA;RC;;1411;1470;2881
3216;GROTTOLE;MT;;1016;1047;2063
3217;GROTTOLELLA;AV;;911;905;1816
3218;GRUARO;VE;;1326;1415;2741
3219;GRUGLIASCO;TO;;17792;19298;37090
3220;GRUMELLO CREMONESE ED UNITI;CR;;849;843;1692
3221;GRUMELLO DEL MONTE;BG;;3656;3736;7392
3222;GRUMENTO NOVA;PZ;;778;790;1568
3223;GRUMO APPULA;BA;;6196;6088;12284
3224;GRUMO NEVANO;NA;;8686;8517;17203
3225;GRUMOLO DELLE ABBADESSE;VI;;1941;1867;3808
3226;GUAGNANO;LE;;2642;2844;5486
3227;GUALDO;MC;;348;373;721
3228;GUALDO CATTANEO;PG;;2914;2777;5691
3229;GUALDO TADINO;PG;;6792;7521;14313
3230;GUALTIERI;RE;;3143;3119;6262
3231;GUALTIERI SICAMINO';ME;;755;836;1591
3232;GUAMAGGIORE;SU;;459;460;919
3233;GUANZATE;CO;;2887;2908;5795
3234;GUARCINO;FR;;764;741;1505
3235;GUARDA VENETA;RO;;539;563;1102
3236;GUARDABOSONE;VC;;165;169;334
3237;GUARDAMIGLIO;LO;;1358;1276;2634
3238;GUARDAVALLE;CZ;;2006;2167;4173
3239;GUARDEA;TR;;862;888;1750
3240;GUARDIA LOMBARDI;AV;;735;791;1526
3241;GUARDIA PERTICARA;PZ;;253;267;520
3242;GUARDIA PIEMONTESE;CS;;832;894;1726
3243;GUARDIA SANFRAMONDI;BN;;2310;2328;4638
3244;GUARDIAGRELE;CH;;4214;4334;8548
3245;GUARDIALFIERA;CB;;467;489;956
3246;GUARDIAREGIA;CB;;356;359;715
3247;GUARDISTALLO;PI;;560;601;1161
3248;GUARENE;CN;;1741;1772;3513
3249;GUASILA;SU;;1260;1249;2509
3250;GUASTALLA;RE;;7167;7494;14661
3251;GUAZZORA;AL;;145;147;292
3252;GUBBIO;PG;;14920;15730;30650
3253;GUDO VISCONTI;MI;;801;833;1634
3254;GUGLIONESI;CB;;2496;2430;4926
3255;GUIDIZZOLO;MN;;2975;2996;5971
3256;GUIDONIA MONTECELIO;RM;;43989;44653;88642
3257;GUIGLIA;MO;;2047;2002;4049
3258;GUILMI;CH;;208;196;404
3259;GURRO;VB;;92;98;190
3260;GUSPINI;SU;;5505;5629;11134
3261;GUSSAGO;BS;;8064;8375;16439
3262;GUSSOLA;CR;;1298;1312;2610
3263;HONE;AO;;559;589;1148
3264;IDRO;BS;;941;932;1873
3265;IGLESIAS;SU;;12203;13179;25382
3266;IGLIANO;CN;;36;31;67
3267;ILBONO;NU;;985;1019;2004
3268;ILLASI;VR;;2608;2548;5156
3269;ILLORAI;SS;;348;415;763
3270;IMBERSAGO;LC;;1227;1253;2480
3271;IMER;TN;;609;562;1171
3272;IMOLA;BO;;33608;35943;69551
3273;IMPERIA;IM;;20479;21481;41960
3274;IMPRUNETA;FI;;6969;7508;14477
3275;INARZO;VA;;513;548;1061
3276;INCISA SCAPACCINO;AT;;1032;996;2028
3277;INCUDINE;BS;;166;179;345
3278;INDUNO OLONA;VA;;5058;5220;10278
3279;INGRIA;TO;;25;17;42
3280;INTRAGNA;VB;;55;45;100
3281;INTROBIO;LC;;972;947;1919
3282;INTROD;AO;;331;311;642
3283;INTRODACQUA;AQ;;975;998;1973
3284;INVERIGO;CO;;4519;4598;9117
3285;INVERNO E MONTELEONE;PV;;740;712;1452
3286;INVERSO PINASCA;TO;;350;347;697
3287;INVERUNO;MI;;4125;4362;8487
3288;INVORIO;NO;;2120;2188;4308
3289;INZAGO;MI;;5578;5667;11245
3290;IRGOLI;NU;;1123;1109;2232
3291;IRMA;BS;;75;61;136
3292;IRSINA;MT;;2208;2233;4441
3293;ISASCA;CN;;42;30;72
3294;ISCA SULLO IONIO;CZ;;735;756;1491
3295;ISCHIA;NA;;9721;9821;19542
3296;ISCHIA DI CASTRO;VT;;1049;1139;2188
3297;ISCHITELLA;FG;;2068;2087;4155
3298;ISEO;BS;;4272;4652;8924
3299;ISERA;TN;;1376;1400;2776
3300;ISERNIA;IS;;9986;10762;20748
3301;ISILI;SU;;1224;1279;2503
3302;ISNELLO;PA;;638;696;1334
3303;ISOLA D'ASTI;AT;;964;1000;1964
3304;ISOLA DEL CANTONE;GE;;701;691;1392
3305;ISOLA DEL GIGLIO;GR;;714;630;1344
3306;ISOLA DEL GRAN SASSO D'ITALIA;TE;;2217;2255;4472
3307;ISOLA DEL LIRI;FR;;5230;5624;10854
3308;ISOLA DEL PIANO;PU;;280;276;556
3309;ISOLA DELLA SCALA;VR;;5809;5719;11528
3310;ISOLA DELLE FEMMINE;PA;;3526;3558;7084
3311;ISOLA DI CAPO RIZZUTO;KR;;8958;8323;17281
3312;ISOLA DI FONDRA;BG;;89;82;171
3313;ISOLA DOVARESE;CR;;548;543;1091
3314;ISOLA RIZZA;VR;;1631;1599;3230
3315;ISOLA SANT'ANTONIO;AL;;332;312;644
3316;ISOLA VICENTINA;VI;;5104;5164;10268
3317;ISOLABELLA;TO;;185;190;375
3318;ISOLABONA;IM;;334;343;677
3319;ISOLE TREMITI;FG;;266;198;464
3320;ISORELLA;BS;;2074;1990;4064
3321;ISPANI;SA;;493;495;988
3322;ISPICA;RG;;8305;7882;16187
3323;ISPRA;VA;;2558;2739;5297
3324;ISSIGLIO;TO;;200;209;409
3325;ISSIME;AO;;188;190;378
3326;ISSO;BG;;323;299;622
3327;ISSOGNE;AO;;660;663;1323
3328;ISTRANA;TV;;4692;4396;9088
3329;ITALA;ME;;719;776;1495
3330;ITRI;LT;;5248;5123;10371
3331;ITTIREDDU;SS;;247;234;481
3332;ITTIRI;SS;;3987;4110;8097
3333;IVREA;TO;;10774;11830;22604
3334;IZANO;CR;;973;976;1949
3335;JACURSO;CZ;;263;299;562
3336;JELSI;CB;;833;805;1638
3337;JENNE;RM;;165;171;336
3338;JERAGO CON ORAGO;VA;;2609;2664;5273
3339;JERZU;NU;;1507;1547;3054
3340;JESI;AN;;18896;20321;39217
3341;JESOLO;VE;;12892;13664;26556
3342;JOLANDA DI SAVOIA;FE;;1282;1356;2638
3343;JONADI;VV;;2209;2293;4502
3344;JOPPOLO;VV;;839;832;1671
3345;JOPPOLO GIANCAXIO;AG;;514;570;1084
3346;JOVENCAN;AO;;359;357;716
3347;L'AQUILA;AQ;;34088;35122;69210
3348;LA CASSA;TO;;900;873;1773
3349;LA LOGGIA;TO;;4363;4416;8779
3350;LA MADDALENA;SS;;5314;5373;10687
3351;LA MAGDELEINE;AO;;64;44;108
3352;LA MORRA;CN;;1361;1314;2675
3353;LA SALLE;AO;;1017;1004;2021
3354;LA SPEZIA;SP;;44414;47755;92169
3355;LA THUILE;AO;;414;402;816
3356;LA VALLE AGORDINA;BL;;542;518;1060
3357;LA VALLE/WENGEN;BZ;;730;672;1402
3358;LA VALLETTA BRIANZA;LC;;2351;2319;4670
3359;LABICO;RM;;3192;3257;6449
3360;LABRO;RI;;185;187;372
3361;LACCHIARELLA;MI;;4427;4633;9060
3362;LACCO AMENO;NA;;2269;2373;4642
3363;LACEDONIA;AV;;1028;1036;2064
3364;LACES/LATSCH;BZ;;2594;2608;5202
3365;LACONI;OR;;831;854;1685
3366;LADISPOLI;RM;;19825;20768;40593
3367;LAERRU;SS;;426;433;859
3368;LAGANADI;RC;;175;177;352
3369;LAGHI;VI;;63;57;120
3370;LAGLIO;CO;;423;476;899
3371;LAGNASCO;CN;;732;663;1395
3372;LAGO;CS;;1132;1171;2303
3373;LAGONEGRO;PZ;;2480;2658;5138
3374;LAGOSANTO;FE;;2279;2451;4730
3375;LAGUNDO/ALGUND;BZ;;2438;2612;5050
3376;LAIGUEGLIA;SV;;787;909;1696
3377;LAINATE;MI;;12797;13329;26126
3378;LAINO;CO;;278;266;544
3379;LAINO BORGO;CS;;852;885;1737
3380;LAINO CASTELLO;CS;;363;426;789
3381;LAION/LAJEN;BZ;;1368;1375;2743
3382;LAIVES/LEIFERS;BZ;;9101;9082;18183
3383;LAJATICO;PI;;626;656;1282
3384;LALLIO;BG;;2036;2083;4119
3385;LAMA DEI PELIGNI;CH;;517;570;1087
3386;LAMA MOCOGNO;MO;;1337;1330;2667
3387;LAMBRUGO;CO;;1243;1280;2523
3388;LAMEZIA TERME;CZ;;33186;34227;67413
3389;LAMON;BL;;1301;1365;2666
3390;LAMPEDUSA E LINOSA;AG;;3374;3088;6462
3391;LAMPORECCHIO;PT;;3595;3803;7398
3392;LAMPORO;VC;;253;253;506
3393;LANA/LANA;BZ;;6066;6349;12415
3394;LANCIANO;CH;;16472;17729;34201
3395;LANDIONA;NO;;255;282;537
3396;LANDRIANO;PV;;3214;3232;6446
3397;LANGHIRANO;PR;;5323;5338;10661
3398;LANGOSCO;PV;;186;196;382
3399;LANUSEI;NU;;2527;2564;5091
3400;LANUVIO;RM;;6472;6464;12936
3401;LANZADA;SO;;657;599;1256
3402;LANZO TORINESE;TO;;2376;2517;4893
3403;LAPEDONA;FM;;590;569;1159
3404;LAPIO;AV;;735;711;1446
3405;LAPPANO;CS;;452;432;884
3406;LARCIANO;PT;;3101;3211;6312
3407;LARDIRAGO;PV;;594;544;1138
3408;LARIANO;RM;;6521;6679;13200
3409;LARINO;CB;;3154;3255;6409
3410;LAS PLASSAS;SU;;118;97;215
3411;LASA/LAAS;BZ;;2041;2037;4078
3412;LASCARI;PA;;1785;1889;3674
3413;LASNIGO;CO;;229;227;456
3414;LASTEBASSE;VI;;93;96;189
3415;LASTRA A SIGNA;FI;;9656;10018;19674
3416;LATERA;VT;;416;361;777
3417;LATERINA PERGINE VALDARNO;AR;;3201;3246;6447
3418;LATERZA;TA;;7337;7569;14906
3419;LATIANO;BR;;6618;7042;13660
3420;LATINA;LT;;62568;65293;127861
3421;LATISANA;UD;;6367;6834;13201
3422;LATRONICO;PZ;;2033;2096;4129
3423;LATTARICO;CS;;1861;1913;3774
3424;LAUCO;UD;;338;325;663
3425;LAUREANA CILENTO;SA;;620;605;1225
3426;LAUREANA DI BORRELLO;RC;;2245;2454;4699
3427;LAUREGNO/LAUREIN;BZ;;180;145;325
3428;LAURENZANA;PZ;;805;820;1625
3429;LAURIA;PZ;;5821;6196;12017
3430;LAURIANO;TO;;696;705;1401
3431;LAURINO;SA;;661;648;1309
3432;LAURITO;SA;;356;356;712
3433;LAURO;AV;;1589;1741;3330
3434;LAVAGNA;GE;;5760;6555;12315
3435;LAVAGNO;VR;;4226;4320;8546
3436;LAVARONE;TN;;596;591;1187
3437;LAVELLO;PZ;;6579;6449;13028
3438;LAVENA PONTE TRESA;VA;;2692;2939;5631
3439;LAVENO-MOMBELLO;VA;;3886;4438;8324
3440;LAVENONE;BS;;247;239;486
3441;LAVIANO;SA;;659;679;1338
3442;LAVIS;TN;;4551;4575;9126
3443;LAZISE;VR;;3394;3455;6849
3444;LAZZATE;MB;;3812;3887;7699
3445;LECCE;LE;;45044;49739;94783
3446;LECCE NEI MARSI;AQ;;749;794;1543
3447;LECCO;LC;;22561;24270;46831
3448;LEDRO;TN;;2574;2699;5273
3449;LEFFE;BG;;2150;2158;4308
3450;LEGGIUNO;VA;;1740;1878;3618
3451;LEGNAGO;VR;;12225;13088;25313
3452;LEGNANO;MI;;28953;31002;59955
3453;LEGNARO;PD;;4668;4685;9353
3454;LEI;NU;;239;231;470
3455;LEINI;TO;;8081;8240;16321
3456;LEIVI;GE;;1164;1240;2404
3457;LEMIE;TO;;105;80;185
3458;LENDINARA;RO;;5596;5861;11457
3459;LENI;ME;;346;335;681
3460;LENNA;BG;;264;290;554
3461;LENO;BS;;7165;7078;14243
3462;LENOLA;LT;;2028;2044;4072
3463;LENTA;VC;;400;395;795
3464;LENTATE SUL SEVESO;MB;;7860;7942;15802
3465;LENTELLA;CH;;323;326;649
3466;LENTINI;SR;;10648;11278;21926
3467;LEONESSA;RI;;1077;1072;2149
3468;LEONFORTE;EN;;6096;6417;12513
3469;LEPORANO;TA;;4119;4068;8187
3470;LEQUILE;LE;;4215;4473;8688
3471;LEQUIO BERRIA;CN;;232;200;432
3472;LEQUIO TANARO;CN;;381;371;752
3473;LERCARA FRIDDI;PA;;2989;3340;6329
3474;LERICI;SP;;4506;4991;9497
3475;LERMA;AL;;380;421;801
3476;LESA;NO;;1033;1119;2152
3477;LESEGNO;CN;;392;396;788
3478;LESIGNANO DE' BAGNI;PR;;2553;2501;5054
3479;LESINA;FG;;3111;3109;6220
3480;LESMO;MB;;4182;4237;8419
3481;LESSOLO;TO;;859;918;1777
3482;LESSONA;BI;;1290;1344;2634
3483;LESTIZZA;UD;;1832;1845;3677
3484;LETINO;CE;;301;339;640
3485;LETOJANNI;ME;;1384;1424;2808
3486;LETTERE;NA;;3091;2982;6073
3487;LETTOMANOPPELLO;PE;;1334;1379;2713
3488;LETTOPALENA;CH;;173;147;320
3489;LEVANTO;SP;;2462;2756;5218
3490;LEVATE;BG;;1865;1855;3720
3491;LEVERANO;LE;;6671;7092;13763
3492;LEVICE;CN;;104;100;204
3493;LEVICO TERME;TN;;3952;4182;8134
3494;LEVONE;TO;;217;226;443
3495;LEZZENO;CO;;977;985;1962
3496;LIBERI;CE;;524;563;1087
3497;LIBRIZZI;ME;;768;816;1584
3498;LICATA;AG;;17030;17589;34619
3499;LICCIANA NARDI;MS;;2329;2410;4739
3500;LICENZA;RM;;447;444;891
3501;LICODIA EUBEA;CT;;1402;1360;2762
3502;LIERNA;LC;;1091;1076;2167
3503;LIGNANA;VC;;254;275;529
3504;LIGNANO SABBIADORO;UD;;3365;3468;6833
3505;LILLIANES;AO;;207;225;432
3506;LIMANA;BL;;2643;2697;5340
3507;LIMATOLA;BN;;2127;2024;4151
3508;LIMBADI;VV;;1629;1638;3267
3509;LIMBIATE;MB;;17297;17512;34809
3510;LIMENA;PD;;3986;4111;8097
3511;LIMIDO COMASCO;CO;;1926;1938;3864
3512;LIMINA;ME;;345;393;738
3513;LIMONE PIEMONTE;CN;;711;691;1402
3514;LIMONE SUL GARDA;BS;;555;586;1141
3515;LIMOSANO;CB;;369;330;699
3516;LINAROLO;PV;;1397;1413;2810
3517;LINGUAGLOSSA;CT;;2443;2552;4995
3518;LIONI;AV;;2951;3065;6016
3519;LIPARI;ME;;6381;6127;12508
3520;LIPOMO;CO;;2922;3063;5985
3521;LIRIO;PV;;75;59;134
3522;LISCATE;MI;;2043;1966;4009
3523;LISCIA;CH;;336;312;648
3524;LISCIANO NICCONE;PG;;292;304;596
3525;LISIO;CN;;93;98;191
3526;LISSONE;MB;;22688;23503;46191
3527;LIVERI;NA;;728;776;1504
3528;LIVIGNO;SO;;3522;3289;6811
3529;LIVINALLONGO DEL COL DI LANA;BL;;606;657;1263
3530;LIVO;TN;;403;378;781
3531;LIVO;CO;;93;72;165
3532;LIVORNO;LI;;74340;80143;154483
3533;LIVORNO FERRARIS;VC;;2021;2159;4180
3534;LIVRAGA;LO;;1206;1217;2423
3535;LIZZANELLO;LE;;5767;6073;11840
3536;LIZZANO;TA;;4730;4898;9628
3537;LIZZANO IN BELVEDERE;BO;;1082;1090;2172
3538;LOANO;SV;;5044;5744;10788
3539;LOAZZOLO;AT;;153;143;296
3540;LOCANA;TO;;644;695;1339
3541;LOCATE DI TRIULZI;MI;;5051;5213;10264
3542;LOCATE VARESINO;CO;;2159;2144;4303
3543;LOCATELLO;BG;;411;412;823
3544;LOCERI;NU;;623;656;1279
3545;LOCOROTONDO;BA;;6834;7144;13978
3546;LOCRI;RC;;5750;6172;11922
3547;LOCULI;NU;;272;236;508
3548;LODE';NU;;786;743;1529
3549;LODI;LO;;21594;23122;44716
3550;LODI VECCHIO;LO;;3638;3847;7485
3551;LODINE;NU;;160;147;307
3552;LODRINO;BS;;848;776;1624
3553;LOGRATO;BS;;1914;1890;3804
3554;LOIANO;BO;;2173;2196;4369
3555;LOIRI PORTO SAN PAOLO;SS;;1857;1802;3659
3556;LOMAGNA;LC;;2491;2535;5026
3557;LOMAZZO;CO;;4870;5074;9944
3558;LOMBARDORE;TO;;849;821;1670
3559;LOMBRIASCO;TO;;567;523;1090
3560;LOMELLO;PV;;966;1056;2022
3561;LONA-LASES;TN;;435;438;873
3562;LONATE CEPPINO;VA;;2482;2551;5033
3563;LONATE POZZOLO;VA;;5635;5731;11366
3564;LONATO DEL GARDA;BS;;8333;8494;16827
3565;LONDA;FI;;949;875;1824
3566;LONGANO;IS;;321;316;637
3567;LONGARE;VI;;2782;2741;5523
3568;LONGARONE;BL;;2471;2607;5078
3569;LONGHENA;BS;;296;264;560
3570;LONGI;ME;;655;695;1350
3571;LONGIANO;FC;;3546;3679;7225
3572;LONGOBARDI;CS;;1192;1134;2326
3573;LONGOBUCCO;CS;;1335;1365;2700
3574;LONGONE AL SEGRINO;CO;;960;987;1947
3575;LONGONE SABINO;RI;;279;262;541
3576;LONIGO;VI;;7903;7843;15746
3577;LORANZE';TO;;572;577;1149
3578;LOREGGIA;PD;;3888;3771;7659
3579;LOREGLIA;VB;;107;110;217
3580;LORENZAGO DI CADORE;BL;;289;286;575
3581;LOREO;RO;;1624;1651;3275
3582;LORETO;AN;;6211;6632;12843
3583;LORETO APRUTINO;PE;;3542;3614;7156
3584;LORIA;TV;;4781;4532;9313
3585;LORO CIUFFENNA;AR;;2907;2947;5854
3586;LORO PICENO;MC;;1058;1123;2181
3587;LORSICA;GE;;202;210;412
3588;LOSINE;BS;;316;309;625
3589;LOTZORAI;NU;;1019;1097;2116
3590;LOVERE;BG;;2313;2688;5001
3591;LOVERO;SO;;321;306;627
3592;LOZIO;BS;;178;175;353
3593;LOZZA;VA;;591;612;1203
3594;LOZZO ATESTINO;PD;;1500;1481;2981
3595;LOZZO DI CADORE;BL;;616;656;1272
3596;LOZZOLO;VC;;391;406;797
3597;LU E CUCCARO MONFERRATO;AL;;650;680;1330
3598;LUBRIANO;VT;;427;461;888
3599;LUCCA;LU;;42788;46290;89078
3600;LUCCA SICULA;AG;;844;889;1733
3601;LUCERA;FG;;15310;16148;31458
3602;LUCIGNANO;AR;;1648;1748;3396
3603;LUCINASCO;IM;;162;131;293
3604;LUCITO;CB;;308;322;630
3605;LUCO DEI MARSI;AQ;;3055;2941;5996
3606;LUCOLI;AQ;;455;417;872
3607;LUGAGNANO VAL D'ARDA;PC;;1937;1943;3880
3608;LUGNANO IN TEVERINA;TR;;728;703;1431
3609;LUGO;RA;;15421;16498;31919
3610;LUGO DI VICENZA;VI;;1795;1767;3562
3611;LUINO;VA;;6811;7317;14128
3612;LUISAGO;CO;;1355;1375;2730
3613;LULA;NU;;642;624;1266
3614;LUMARZO;GE;;724;709;1433
3615;LUMEZZANE;BS;;10667;10743;21410
3616;LUNAMATRONA;SU;;798;851;1649
3617;LUNANO;PU;;763;671;1434
3618;LUNGAVILLA;PV;;1179;1278;2457
3619;LUNGRO;CS;;1112;1115;2227
3620;LUNI;SP;;4022;4186;8208
3621;LUOGOSANO;AV;;571;526;1097
3622;LUOGOSANTO;SS;;920;898;1818
3623;LUPARA;CB;;203;212;415
3624;LURAGO D'ERBA;CO;;2672;2733;5405
3625;LURAGO MARINONE;CO;;1278;1275;2553
3626;LURANO;BG;;1439;1372;2811
3627;LURAS;SS;;1182;1247;2429
3628;LURATE CACCIVIO;CO;;4749;4959;9708
3629;LUSCIANO;CE;;7726;8116;15842
3630;LUSERNA;TN;;131;139;270
3631;LUSERNA SAN GIOVANNI;TO;;3448;3714;7162
3632;LUSERNETTA;TO;;247;233;480
3633;LUSEVERA;UD;;284;301;585
3634;LUSIA;RO;;1650;1673;3323
3635;LUSIANA CONCO;VI;;2315;2238;4553
3636;LUSIGLIE';TO;;262;279;541
3637;LUSON/LUSEN;BZ;;771;775;1546
3638;LUSTRA;SA;;501;493;994
3639;LUVINATE;VA;;650;660;1310
3640;LUZZANA;BG;;456;425;881
3641;LUZZARA;RE;;4256;4146;8402
3642;LUZZI;CS;;4308;4488;8796
3643;MACCAGNO CON PINO E VEDDASCA;VA;;1174;1229;2403
3644;MACCASTORNA;LO;;35;28;63
3645;MACCHIA D'ISERNIA;IS;;528;502;1030
3646;MACCHIA VALFORTORE;CB;;246;244;490
3647;MACCHIAGODENA;IS;;812;843;1655
3648;MACELLO;TO;;573;582;1155
3649;MACERATA;MC;;19412;21091;40503
3650;MACERATA CAMPANIA;CE;;4942;5106;10048
3651;MACERATA FELTRIA;PU;;889;1026;1915
3652;MACHERIO;MB;;3678;3771;7449
3653;MACLODIO;BS;;752;731;1483
3654;MACOMER;NU;;4588;4856;9444
3655;MACRA;CN;;24;19;43
3656;MACUGNAGA;VB;;270;256;526
3657;MADDALONI;CE;;18135;19011;37146
3658;MADESIMO;SO;;274;256;530
3659;MADIGNANO;CR;;1385;1375;2760
3660;MADONE;BG;;2038;1987;4025
3661;MADONNA DEL SASSO;VB;;186;185;371
3662;MADRUZZO;TN;;1522;1441;2963
3663;MAENZA;LT;;1452;1525;2977
3664;MAFALDA;CB;;553;539;1092
3665;MAGASA;BS;;58;49;107
3666;MAGENTA;MI;;11676;12454;24130
3667;MAGGIORA;NO;;775;834;1609
3668;MAGHERNO;PV;;873;881;1754
3669;MAGIONE;PG;;7128;7474;14602
3670;MAGISANO;CZ;;544;567;1111
3671;MAGLIANO ALFIERI;CN;;1059;1114;2173
3672;MAGLIANO ALPI;CN;;1056;1074;2130
3673;MAGLIANO DE' MARSI;AQ;;1718;1807;3525
3674;MAGLIANO DI TENNA;FM;;715;717;1432
3675;MAGLIANO IN TOSCANA;GR;;1597;1719;3316
3676;MAGLIANO ROMANO;RM;;711;704;1415
3677;MAGLIANO SABINA;RI;;1719;1764;3483
3678;MAGLIANO VETERE;SA;;290;316;606
3679;MAGLIE;LE;;6407;7212;13619
3680;MAGLIOLO;SV;;482;451;933
3681;MAGLIONE;TO;;206;213;419
3682;MAGNACAVALLO;MN;;716;712;1428
3683;MAGNAGO;MI;;4630;4706;9336
3684;MAGNANO;BI;;198;168;366
3685;MAGNANO IN RIVIERA;UD;;1125;1148;2273
3686;MAGOMADAS;OR;;316;288;604
3687;MAGRE' SULLA STRADA DEL VINO/MARGREID AN DER WEINSTRASSE;BZ;;632;660;1292
3688;MAGREGLIO;CO;;347;340;687
3689;MAIDA;CZ;;2174;2254;4428
3690;MAIERA';CS;;577;562;1139
3691;MAIERATO;VV;;992;1064;2056
3692;MAIOLATI SPONTINI;AN;;2919;3178;6097
3693;MAIOLO;RN;;403;382;785
3694;MAIORI;SA;;2663;2734;5397
3695;MAIRAGO;LO;;696;689;1385
3696;MAIRANO;BS;;1768;1724;3492
3697;MAISSANA;SP;;321;262;583
3698;MAJANO;UD;;2805;3029;5834
3699;MALAGNINO;CR;;845;874;1719
3700;MALALBERGO;BO;;4383;4662;9045
3701;MALBORGHETTO VALBRUNA;UD;;466;444;910
3702;MALCESINE;VR;;1737;1859;3596
3703;MALE';TN;;1092;1173;2265
3704;MALEGNO;BS;;981;979;1960
3705;MALEO;LO;;1480;1537;3017
3706;MALESCO;VB;;675;685;1360
3707;MALETTO;CT;;1742;1856;3598
3708;MALFA;ME;;498;480;978
3709;MALGRATE;LC;;2076;2220;4296
3710;MALITO;CS;;369;378;747
3711;MALLARE;SV;;512;549;1061
3712;MALLES VENOSTA/MALS;BZ;;2672;2561;5233
3713;MALNATE;VA;;7930;8417;16347
3714;MALO;VI;;7343;7339;14682
3715;MALONNO;BS;;1481;1549;3030
3716;MALTIGNANO;AP;;1116;1143;2259
3717;MALVAGNA;ME;;300;339;639
3718;MALVICINO;AL;;35;44;79
3719;MALVITO;CS;;837;824;1661
3720;MAMMOLA;RC;;1217;1281;2498
3721;MAMOIADA;NU;;1185;1241;2426
3722;MANCIANO;GR;;3450;3663;7113
3723;MANDANICI;ME;;256;275;531
3724;MANDAS;SU;;1021;1007;2028
3725;MANDATORICCIO;CS;;1224;1231;2455
3726;MANDELA;RM;;452;454;906
3727;MANDELLO DEL LARIO;LC;;4925;5089;10014
3728;MANDELLO VITTA;NO;;110;118;228
3729;MANDURIA;TA;;14639;15478;30117
3730;MANERBA DEL GARDA;BS;;2713;2702;5415
3731;MANERBIO;BS;;6447;6716;13163
3732;MANFREDONIA;FG;;27023;27319;54342
3733;MANGO;CN;;635;618;1253
3734;MANGONE;CS;;946;939;1885
3735;MANIACE;CT;;1877;1891;3768
3736;MANIAGO;PN;;5676;5879;11555
3737;MANOCALZATI;AV;;1527;1524;3051
3738;MANOPPELLO;PE;;3307;3464;6771
3739;MANSUE';TV;;2522;2445;4967
3740;MANTA;CN;;1856;1909;3765
3741;MANTELLO;SO;;365;388;753
3742;MANTOVA;MN;;22916;25525;48441
3743;MANZANO;UD;;3012;3226;6238
3744;MANZIANA;RM;;3763;3972;7735
3745;MAPELLO;BG;;3491;3387;6878
3746;MAPPANO;TO;;3652;3717;7369
3747;MARA;SS;;253;273;526
3748;MARACALAGONIS;CA;;4036;3873;7909
3749;MARANELLO;MO;;8647;8623;17270
3750;MARANO DI NAPOLI;NA;;28208;29834;58042
3751;MARANO DI VALPOLICELLA;VR;;1552;1563;3115
3752;MARANO EQUO;RM;;400;384;784
3753;MARANO LAGUNARE;UD;;879;877;1756
3754;MARANO MARCHESATO;CS;;1635;1698;3333
3755;MARANO PRINCIPATO;CS;;1519;1544;3063
3756;MARANO SUL PANARO;MO;;2645;2678;5323
3757;MARANO TICINO;NO;;779;789;1568
3758;MARANO VICENTINO;VI;;4696;4655;9351
3759;MARANZANA;AT;;128;102;230
3760;MARATEA;PZ;;2369;2448;4817
3761;MARCALLO CON CASONE;MI;;3053;3133;6186
3762;MARCARIA;MN;;3157;3206;6363
3763;MARCEDUSA;CZ;;204;191;395
3764;MARCELLINA;RM;;3578;3512;7090
3765;MARCELLINARA;CZ;;1068;1114;2182
3766;MARCETELLI;RI;;35;34;69
3767;MARCHENO;BS;;2114;2082;4196
3768;MARCHIROLO;VA;;1702;1810;3512
3769;MARCIANA;LI;;983;1047;2030
3770;MARCIANA MARINA;LI;;929;947;1876
3771;MARCIANISE;CE;;18823;19700;38523
3772;MARCIANO DELLA CHIANA;AR;;1677;1781;3458
3773;MARCIGNAGO;PV;;1212;1214;2426
3774;MARCON;VE;;8768;8790;17558
3775;MAREBBE/ENNEBERG;BZ;;1597;1562;3159
3776;MARENE;CN;;1610;1659;3269
3777;MARENO DI PIAVE;TV;;4768;4780;9548
3778;MARENTINO;TO;;663;637;1300
3779;MARETTO;AT;;200;180;380
3780;MARGARITA;CN;;697;732;1429
3781;MARGHERITA DI SAVOIA;BT;;5521;5741;11262
3782;MARGNO;LC;;198;177;375
3783;MARIANA MANTOVANA;MN;;395;409;804
3784;MARIANO COMENSE;CO;;12387;12795;25182
3785;MARIANO DEL FRIULI;GO;;728;736;1464
3786;MARIANOPOLI;CL;;790;852;1642
3787;MARIGLIANELLA;NA;;3891;3941;7832
3788;MARIGLIANO;NA;;14014;15152;29166
3789;MARINA DI GIOIOSA IONICA;RC;;3034;3270;6304
3790;MARINEO;PA;;3054;3160;6214
3791;MARINO;RM;;22486;23562;46048
3792;MARLENGO/MARLING;BZ;;1445;1393;2838
3793;MARLIANA;PT;;1594;1555;3149
3794;MARMENTINO;BS;;339;326;665
3795;MARMIROLO;MN;;3752;3873;7625
3796;MARMORA;CN;;29;25;54
3797;MARNATE;VA;;3982;4050;8032
3798;MARONE;BS;;1507;1607;3114
3799;MAROPATI;RC;;689;696;1385
3800;MAROSTICA;VI;;6948;7018;13966
3801;MARRADI;FI;;1468;1423;2891
3802;MARRUBIU;OR;;2365;2278;4643
3803;MARSAGLIA;CN;;110;104;214
3804;MARSALA;TP;;39692;40782;80474
3805;MARSCIANO;PG;;8802;9236;18038
3806;MARSICO NUOVO;PZ;;1875;1995;3870
3807;MARSICOVETERE;PZ;;2759;2797;5556
3808;MARTA;VT;;1562;1709;3271
3809;MARTANO;LE;;4154;4466;8620
3810;MARTELLAGO;VE;;10369;10910;21279
3811;MARTELLO/MARTELL;BZ;;455;373;828
3812;MARTIGNACCO;UD;;3297;3550;6847
3813;MARTIGNANA DI PO;CR;;1021;1024;2045
3814;MARTIGNANO;LE;;782;804;1586
3815;MARTINA FRANCA;TA;;22853;24448;47301
3816;MARTINENGO;BG;;5473;5260;10733
3817;MARTINIANA PO;CN;;425;327;752
3818;MARTINSICURO;TE;;7996;8223;16219
3819;MARTIRANO;CZ;;430;424;854
3820;MARTIRANO LOMBARDO;CZ;;481;499;980
3821;MARTIS;SS;;234;236;470
3822;MARTONE;RC;;248;255;503
3823;MARUDO;LO;;904;865;1769
3824;MARUGGIO;TA;;2636;2652;5288
3825;MARZABOTTO;BO;;3392;3414;6806
3826;MARZANO;PV;;866;818;1684
3827;MARZANO APPIO;CE;;1014;999;2013
3828;MARZANO DI NOLA;AV;;793;831;1624
3829;MARZI;CS;;492;472;964
3830;MARZIO;VA;;164;146;310
3831;MASAINAS;SU;;595;632;1227
3832;MASATE;MI;;1838;1833;3671
3833;MASCALI;CT;;7029;7258;14287
3834;MASCALUCIA;CT;;15608;16390;31998
3835;MASCHITO;PZ;;734;772;1506
3836;MASCIAGO PRIMO;VA;;154;149;303
3837;MASER;TV;;2540;2585;5125
3838;MASERA;VB;;728;748;1476
3839;MASERA' DI PADOVA;PD;;4545;4547;9092
3840;MASERADA SUL PIAVE;TV;;4593;4632;9225
3841;MASI;PD;;868;912;1780
3842;MASI TORELLO;FE;;1082;1209;2291
3843;MASIO;AL;;661;617;1278
3844;MASLIANICO;CO;;1536;1595;3131
3845;MASONE;GE;;1685;1758;3443
3846;MASSA;MS;;32150;34348;66498
3847;MASSA D'ALBE;AQ;;700;665;1365
3848;MASSA DI SOMMA;NA;;2476;2580;5056
3849;MASSA E COZZILE;PT;;3669;4029;7698
3850;MASSA FERMANA;FM;;420;458;878
3851;MASSA LOMBARDA;RA;;5297;5293;10590
3852;MASSA LUBRENSE;NA;;6955;7191;14146
3853;MASSA MARITTIMA;GR;;3884;4240;8124
3854;MASSA MARTANA;PG;;1846;1795;3641
3855;MASSAFRA;TA;;15864;16252;32116
3856;MASSALENGO;LO;;2235;2144;4379
3857;MASSANZAGO;PD;;3061;2982;6043
3858;MASSAROSA;LU;;10682;11141;21823
3859;MASSAZZA;BI;;296;273;569
3860;MASSELLO;TO;;30;27;57
3861;MASSERANO;BI;;938;978;1916
3862;MASSIGNANO;AP;;823;812;1635
3863;MASSIMENO;TN;;79;65;144
3864;MASSIMINO;SV;;49;48;97
3865;MASSINO VISCONTI;NO;;554;570;1124
3866;MASSIOLA;VB;;64;53;117
3867;MASULLAS;OR;;527;485;1012
3868;MATELICA;MC;;4491;4799;9290
3869;MATERA;MT;;29111;30637;59748
3870;MATHI;TO;;1880;1897;3777
3871;MATINO;LE;;5327;5666;10993
3872;MATRICE;CB;;521;535;1056
3873;MATTIE;TO;;325;333;658
3874;MATTINATA;FG;;2962;3069;6031
3875;MAZARA DEL VALLO;TP;;24906;25406;50312
3876;MAZZANO;BS;;6258;6261;12519
3877;MAZZANO ROMANO;RM;;1486;1483;2969
3878;MAZZARINO;CL;;5297;5789;11086
3879;MAZZARRA' SANT'ANDREA;ME;;720;680;1400
3880;MAZZARRONE;CT;;1971;1984;3955
3881;MAZZE';TO;;2048;2133;4181
3882;MAZZIN;TN;;291;297;588
3883;MAZZO DI VALTELLINA;SO;;514;514;1028
3884;MEANA DI SUSA;TO;;413;392;805
3885;MEANA SARDO;NU;;808;816;1624
3886;MEDA;MB;;11491;11859;23350
3887;MEDE;PV;;2982;3229;6211
3888;MEDEA;GO;;472;477;949
3889;MEDESANO;PR;;5322;5371;10693
3890;MEDICINA;BO;;8170;8476;16646
3891;MEDIGLIA;MI;;6130;6163;12293
3892;MEDOLAGO;BG;;1180;1165;2345
3893;MEDOLE;MN;;2061;2035;4096
3894;MEDOLLA;MO;;3100;3252;6352
3895;MEDUNA DI LIVENZA;TV;;1469;1478;2947
3896;MEDUNO;PN;;753;751;1504
3897;MEGLIADINO SAN VITALE;PD;;916;903;1819
3898;MEINA;NO;;1101;1271;2372
3899;MELARA;RO;;819;883;1702
3900;MELAZZO;AL;;625;633;1258
3901;MELDOLA;FC;;4876;5005;9881
3902;MELE;GE;;1270;1322;2592
3903;MELEGNANO;MI;;8578;9394;17972
3904;MELENDUGNO;LE;;4887;5109;9996
3905;MELETI;LO;;217;228;445
3906;MELFI;PZ;;8433;8676;17109
3907;MELICUCCA';RC;;405;449;854
3908;MELICUCCO;RC;;2421;2468;4889
3909;MELILLI;SR;;6726;6501;13227
3910;MELISSA;KR;;1612;1662;3274
3911;MELISSANO;LE;;3257;3514;6771
3912;MELITO DI NAPOLI;NA;;17933;18523;36456
3913;MELITO DI PORTO SALVO;RC;;5183;5394;10577
3914;MELITO IRPINO;AV;;906;891;1797
3915;MELIZZANO;BN;;865;847;1712
3916;MELLE;CN;;161;137;298
3917;MELLO;SO;;477;451;928
3918;MELPIGNANO;LE;;1027;1099;2126
3919;MELTINA/MOLTEN;BZ;;884;821;1705
3920;MELZO;MI;;8916;9587;18503
3921;MENAGGIO;CO;;1508;1527;3035
3922;MENCONICO;PV;;184;168;352
3923;MENDATICA;IM;;95;67;162
3924;MENDICINO;CS;;4620;4588;9208
3925;MENFI;AG;;5792;6137;11929
3926;MENTANA;RM;;11151;11492;22643
3927;MEOLO;VE;;3124;3105;6229
3928;MERANA;AL;;93;92;185
3929;MERANO/MERAN;BZ;;19687;21072;40759
3930;MERATE;LC;;7049;7612;14661
3931;MERCALLO;VA;;896;901;1797
3932;MERCATELLO SUL METAURO;PU;;655;662;1317
3933;MERCATINO CONCA;PU;;504;501;1005
3934;MERCATO SAN SEVERINO;SA;;10599;11080;21679
3935;MERCATO SARACENO;FC;;3441;3371;6812
3936;MERCENASCO;TO;;677;614;1291
3937;MERCOGLIANO;AV;;5647;5988;11635
3938;MERETO DI TOMBA;UD;;1266;1264;2530
3939;MERGO;AN;;490;511;1001
3940;MERGOZZO;VB;;1065;1091;2156
3941;MERI';ME;;1137;1185;2322
3942;MERLARA;PD;;1220;1302;2522
3943;MERLINO;LO;;889;837;1726
3944;MERONE;CO;;2019;2039;4058
3945;MESAGNE;BR;;12521;13593;26114
3946;MESE;SO;;906;918;1824
3947;MESENZANA;VA;;813;843;1656
3948;MESERO;MI;;2103;2088;4191
3949;MESOLA;FE;;3214;3297;6511
3950;MESORACA;KR;;2869;3039;5908
3951;MESSINA;ME;;106126;115120;221246
3952;MESTRINO;PD;;5735;5920;11655
3953;META;NA;;3778;4084;7862
3954;MEZZAGO;MB;;2238;2232;4470
3955;MEZZANA;TN;;437;445;882
3956;MEZZANA BIGLI;PV;;516;535;1051
3957;MEZZANA MORTIGLIENGO;BI;;240;255;495
3958;MEZZANA RABATTONE;PV;;231;236;467
3959;MEZZANE DI SOTTO;VR;;1243;1298;2541
3960;MEZZANEGO;GE;;751;732;1483
3961;MEZZANINO;PV;;667;653;1320
3962;MEZZANO;TN;;802;794;1596
3963;MEZZENILE;TO;;379;357;736
3964;MEZZOCORONA;TN;;2706;2802;5508
3965;MEZZOJUSO;PA;;1320;1362;2682
3966;MEZZOLDO;BG;;83;81;164
3967;MEZZOLOMBARDO;TN;;3679;3766;7445
3968;MEZZOMERICO;NO;;609;594;1203
3969;MIAGLIANO;BI;;256;292;548
3970;MIANE;TV;;1552;1592;3144
3971;MIASINO;NO;;370;441;811
3972;MIAZZINA;VB;;199;169;368
3973;MICIGLIANO;RI;;65;50;115
3974;MIGGIANO;LE;;1543;1753;3296
3975;MIGLIANICO;CH;;2298;2342;4640
3976;MIGLIERINA;CZ;;334;397;731
3977;MIGLIONICO;MT;;1205;1145;2350
3978;MIGNANEGO;GE;;1744;1751;3495
3979;MIGNANO MONTE LUNGO;CE;;1465;1534;2999
3980;MILANO;MI;;652373;697557;1349930
3981;MILAZZO;ME;;14767;15630;30397
3982;MILENA;CL;;1325;1406;2731
3983;MILETO;VV;;3206;3209;6415
3984;MILIS;OR;;726;707;1433
3985;MILITELLO IN VAL DI CATANIA;CT;;3368;3428;6796
3986;MILITELLO ROSMARINO;ME;;588;586;1174
3987;MILLESIMO;SV;;1565;1647;3212
3988;MILO;CT;;530;508;1038
3989;MILZANO;BS;;870;853;1723
3990;MINEO;CT;;2267;2340;4607
3991;MINERBE;VR;;2258;2276;4534
3992;MINERBIO;BO;;4360;4494;8854
3993;MINERVINO DI LECCE;LE;;1653;1847;3500
3994;MINERVINO MURGE;BT;;4077;4221;8298
3995;MINORI;SA;;1291;1305;2596
3996;MINTURNO;LT;;9988;10227;20215
3997;MINUCCIANO;LU;;895;931;1826
3998;MIOGLIA;SV;;237;253;490
3999;MIRA;VE;;18366;19210;37576
4000;MIRABELLA ECLANO;AV;;3325;3407;6732
4001;MIRABELLA IMBACCARI;CT;;2022;2258;4280
4002;MIRABELLO MONFERRATO;AL;;599;612;1211
4003;MIRABELLO SANNITICO;CB;;1014;1023;2037
4004;MIRADOLO TERME;PV;;1863;1814;3677
4005;MIRANDA;IS;;474;483;957
4006;MIRANDOLA;MO;;11790;12345;24135
4007;MIRANO;VE;;13187;13996;27183
4008;MIRTO;ME;;439;467;906
4009;MISANO ADRIATICO;RN;;6882;7031;13913
4010;MISANO DI GERA D'ADDA;BG;;1468;1476;2944
4011;MISILISCEMI;TP;;4250;4165;8415
4012;MISILMERI;PA;;14327;14567;28894
4013;MISINTO;MB;;2829;2835;5664
4014;MISSAGLIA;LC;;4348;4419;8767
4015;MISSANELLO;PZ;;235;248;483
4016;MISTERBIANCO;CT;;24087;25207;49294
4017;MISTRETTA;ME;;2044;2344;4388
4018;MOASCA;AT;;270;244;514
4019;MOCONESI;GE;;1234;1203;2437
4020;MODENA;MO;;89497;95474;184971
4021;MODICA;RG;;25907;27647;53554
4022;MODIGLIANA;FC;;2143;2183;4326
4023;MODOLO;OR;;74;81;155
4024;MODUGNO;BA;;17787;18752;36539
4025;MOENA;TN;;1263;1326;2589
4026;MOGGIO;LC;;229;244;473
4027;MOGGIO UDINESE;UD;;799;822;1621
4028;MOGLIA;MN;;2659;2694;5353
4029;MOGLIANO;MC;;2141;2231;4372
4030;MOGLIANO VENETO;TV;;13532;14094;27626
4031;MOGORELLA;OR;;209;203;412
4032;MOGORO;OR;;1974;1985;3959
4033;MOIANO;BN;;1995;2057;4052
4034;MOIMACCO;UD;;821;811;1632
4035;MOIO ALCANTARA;ME;;332;353;685
4036;MOIO DE' CALVI;BG;;97;98;195
4037;MOIO DELLA CIVITELLA;SA;;875;927;1802
4038;MOIOLA;CN;;116;102;218
4039;MOLA DI BARI;BA;;12135;12490;24625
4040;MOLARE;AL;;958;1055;2013
4041;MOLAZZANA;LU;;492;518;1010
4042;MOLFETTA;BA;;28013;29632;57645
4043;MOLINA ATERNO;AQ;;178;176;354
4044;MOLINARA;BN;;716;755;1471
4045;MOLINELLA;BO;;7626;8004;15630
4046;MOLINI DI TRIORA;IM;;332;290;622
4047;MOLINO DEI TORTI;AL;;304;261;565
4048;MOLISE;CB;;85;73;158
4049;MOLITERNO;PZ;;1734;1897;3631
4050;MOLLIA;VC;;49;44;93
4051;MOLOCHIO;RC;;1094;1168;2262
4052;MOLTENO;LC;;1770;1764;3534
4053;MOLTRASIO;CO;;732;812;1544
4054;MOLVENO;TN;;532;565;1097
4055;MOMBALDONE;AT;;105;88;193
4056;MOMBARCARO;CN;;123;127;250
4057;MOMBAROCCIO;PU;;1037;1026;2063
4058;MOMBARUZZO;AT;;505;481;986
4059;MOMBASIGLIO;CN;;295;322;617
4060;MOMBELLO DI TORINO;TO;;196;191;387
4061;MOMBELLO MONFERRATO;AL;;443;482;925
4062;MOMBERCELLI;AT;;1036;1073;2109
4063;MOMO;NO;;1145;1248;2393
4064;MOMPANTERO;TO;;301;341;642
4065;MOMPEO;RI;;248;256;504
4066;MOMPERONE;AL;;104;91;195
4067;MONACILIONI;CB;;222;257;479
4068;MONALE;AT;;478;506;984
4069;MONASTERACE;RC;;1654;1657;3311
4070;MONASTERO BORMIDA;AT;;402;470;872
4071;MONASTERO DI LANZO;TO;;173;155;328
4072;MONASTERO DI VASCO;CN;;609;650;1259
4073;MONASTEROLO CASOTTO;CN;;42;38;80
4074;MONASTEROLO DEL CASTELLO;BG;;569;572;1141
4075;MONASTEROLO DI SAVIGLIANO;CN;;662;673;1335
4076;MONASTIER DI TREVISO;TV;;2198;2231;4429
4077;MONASTIR;SU;;2210;2259;4469
4078;MONCALIERI;TO;;27259;28934;56193
4079;MONCALVO;AT;;1310;1435;2745
4080;MONCENISIO;TO;;20;21;41
4081;MONCESTINO;AL;;93;103;196
4082;MONCHIERO;CN;;299;286;585
4083;MONCHIO DELLE CORTI;PR;;450;387;837
4084;MONCRIVELLO;VC;;689;687;1376
4085;MONCUCCO TORINESE;AT;;437;446;883
4086;MONDAINO;RN;;656;663;1319
4087;MONDAVIO;PU;;1783;1875;3658
4088;MONDOLFO;PU;;7165;7173;14338
4089;MONDOVI';CN;;10799;11216;22015
4090;MONDRAGONE;CE;;14231;14243;28474
4091;MONEGLIA;GE;;1227;1362;2589
4092;MONESIGLIO;CN;;276;319;595
4093;MONFALCONE;GO;;14916;14156;29072
4094;MONFORTE D'ALBA;CN;;969;985;1954
4095;MONFORTE SAN GIORGIO;ME;;1230;1317;2547
4096;MONFUMO;TV;;656;659;1315
4097;MONGARDINO;AT;;431;432;863
4098;MONGHIDORO;BO;;1936;1815;3751
4099;MONGIANA;VV;;329;321;650
4100;MONGIARDINO LIGURE;AL;;82;72;154
4101;MONGIUFFI MELIA;ME;;272;265;537
4102;MONGRANDO;BI;;1774;1893;3667
4103;MONGRASSANO;CS;;737;742;1479
4104;MONGUELFO-TESIDO/WELSBERG-TAISTEN;BZ;;1438;1442;2880
4105;MONGUZZO;CO;;1185;1182;2367
4106;MONIGA DEL GARDA;BS;;1271;1332;2603
4107;MONLEALE;AL;;274;279;553
4108;MONNO;BS;;246;269;515
4109;MONOPOLI;BA;;23435;24643;48078
4110;MONREALE;PA;;19030;19635;38665
4111;MONRUPINO;TS;;434;423;857
4112;MONSAMPIETRO MORICO;FM;;306;315;621
4113;MONSAMPOLO DEL TRONTO;AP;;2215;2234;4449
4114;MONSANO;AN;;1605;1705;3310
4115;MONSELICE;PD;;8365;8877;17242
4116;MONSERRATO;CA;;9132;9986;19118
4117;MONSUMMANO TERME;PT;;10131;10690;20821
4118;MONTA';CN;;2260;2424;4684
4119;MONTABONE;AT;;161;150;311
4120;MONTACUTO;AL;;132;119;251
4121;MONTAFIA;AT;;481;446;927
4122;MONTAGANO;CB;;495;513;1008
4123;MONTAGNA IN VALTELLINA;SO;;1425;1538;2963
4124;MONTAGNA SULLA STRADA DEL VINO/MONTAN AN DER WEINSTRASSE;BZ;;831;859;1690
4125;MONTAGNANA;PD;;4335;4563;8898
4126;MONTAGNAREALE;ME;;707;712;1419
4127;MONTAGUTO;AV;;171;179;350
4128;MONTAIONE;FI;;1719;1780;3499
4129;MONTALBANO ELICONA;ME;;975;1046;2021
4130;MONTALBANO JONICO;MT;;3347;3449;6796
4131;MONTALCINO;SI;;2786;2890;5676
4132;MONTALDEO;AL;;108;124;232
4133;MONTALDO BORMIDA;AL;;309;299;608
4134;MONTALDO DI MONDOVI';CN;;263;267;530
4135;MONTALDO ROERO;CN;;423;439;862
4136;MONTALDO SCARAMPI;AT;;329;370;699
4137;MONTALDO TORINESE;TO;;359;377;736
4138;MONTALE;PT;;5176;5432;10608
4139;MONTALENGHE;TO;;467;503;970
4140;MONTALLEGRO;AG;;1170;1224;2394
4141;MONTALTO CARPASIO;IM;;256;246;502
4142;MONTALTO DELLE MARCHE;AP;;901;1038;1939
4143;MONTALTO DI CASTRO;VT;;4387;4408;8795
4144;MONTALTO DORA;TO;;1612;1692;3304
4145;MONTALTO PAVESE;PV;;439;421;860
4146;MONTALTO UFFUGO;CS;;9855;10304;20159
4147;MONTANARO;TO;;2514;2604;5118
4148;MONTANASO LOMBARDO;LO;;1100;1134;2234
4149;MONTANERA;CN;;365;349;714
4150;MONTANO ANTILIA;SA;;839;892;1731
4151;MONTANO LUCINO;CO;;2625;2715;5340
4152;MONTAPPONE;FM;;768;816;1584
4153;MONTAQUILA;IS;;1165;1138;2303
4154;MONTASOLA;RI;;216;188;404
4155;MONTAURO;CZ;;858;913;1771
4156;MONTAZZOLI;CH;;429;430;859
4157;MONTE ARGENTARIO;GR;;5865;6175;12040
4158;MONTE CASTELLO DI VIBIO;PG;;729;721;1450
4159;MONTE CAVALLO;MC;;53;51;104
4160;MONTE CERIGNONE;PU;;293;327;620
4161;MONTE COMPATRI;RM;;5874;6025;11899
4162;MONTE CREMASCO;CR;;1105;1136;2241
4163;MONTE DI MALO;VI;;1422;1375;2797
4164;MONTE DI PROCIDA;NA;;5784;6145;11929
4165;MONTE GIBERTO;FM;;369;369;738
4166;MONTE GRIMANO TERME;PU;;528;538;1066
4167;MONTE ISOLA;BS;;810;818;1628
4168;MONTE MARENZO;LC;;928;940;1868
4169;MONTE PORZIO;PU;;1368;1384;2752
4170;MONTE PORZIO CATONE;RM;;4133;4451;8584
4171;MONTE RINALDO;FM;;162;162;324
4172;MONTE ROBERTO;AN;;1499;1519;3018
4173;MONTE ROMANO;VT;;951;964;1915
4174;MONTE SAN BIAGIO;LT;;3088;3016;6104
4175;MONTE SAN GIACOMO;SA;;702;734;1436
4176;MONTE SAN GIOVANNI CAMPANO;FR;;6056;6083;12139
4177;MONTE SAN GIOVANNI IN SABINA;RI;;326;329;655
4178;MONTE SAN GIUSTO;MC;;3739;3791;7530
4179;MONTE SAN MARTINO;MC;;362;347;709
4180;MONTE SAN PIETRANGELI;FM;;1127;1166;2293
4181;MONTE SAN PIETRO;BO;;5309;5455;10764
4182;MONTE SAN SAVINO;AR;;4184;4431;8615
4183;MONTE SAN VITO;AN;;3304;3424;6728
4184;MONTE SANT'ANGELO;FG;;5617;5891;11508
4185;MONTE SANTA MARIA TIBERINA;PG;;556;556;1112
4186;MONTE URANO;FM;;3938;3949;7887
4187;MONTE VIDON COMBATTE;FM;;187;213;400
4188;MONTE VIDON CORRADO;FM;;347;336;683
4189;MONTEBELLO DELLA BATTAGLIA;PV;;732;735;1467
4190;MONTEBELLO DI BERTONA;PE;;448;435;883
4191;MONTEBELLO JONICO;RC;;2811;2910;5721
4192;MONTEBELLO SUL SANGRO;CH;;28;46;74
4193;MONTEBELLO VICENTINO;VI;;3184;3135;6319
4194;MONTEBELLUNA;TV;;15199;15863;31062
4195;MONTEBRUNO;GE;;108;99;207
4196;MONTEBUONO;RI;;417;418;835
4197;MONTECALVO IN FOGLIA;PU;;1308;1390;2698
4198;MONTECALVO IRPINO;AV;;1636;1744;3380
4199;MONTECALVO VERSIGGIA;PV;;259;257;516
4200;MONTECARLO;LU;;2110;2256;4366
4201;MONTECAROTTO;AN;;904;956;1860
4202;MONTECASSIANO;MC;;3403;3475;6878
4203;MONTECASTELLO;AL;;143;147;290
4204;MONTECASTRILLI;TR;;2358;2462;4820
4205;MONTECATINI VAL DI CECINA;PI;;829;840;1669
4206;MONTECATINI-TERME;PT;;9652;10816;20468
4207;MONTECCHIA DI CROSARA;VR;;2182;2036;4218
4208;MONTECCHIO;TR;;780;779;1559
4209;MONTECCHIO EMILIA;RE;;5022;5362;10384
4210;MONTECCHIO MAGGIORE;VI;;11841;11375;23216
4211;MONTECCHIO PRECALCINO;VI;;2441;2466;4907
4212;MONTECHIARO D'ACQUI;AL;;260;241;501
4213;MONTECHIARO D'ASTI;AT;;580;626;1206
4214;MONTECHIARUGOLO;PR;;5594;5560;11154
4215;MONTECILFONE;CB;;593;611;1204
4216;MONTECOPIOLO;RN;;522;513;1035
4217;MONTECORICE;SA;;1309;1244;2553
4218;MONTECORVINO PUGLIANO;SA;;5611;5497;11108
4219;MONTECORVINO ROVELLA;SA;;6202;6116;12318
4220;MONTECOSARO;MC;;3619;3684;7303
4221;MONTECRESTESE;VB;;622;651;1273
4222;MONTECRETO;MO;;480;439;919
4223;MONTEDINOVE;AP;;264;208;472
4224;MONTEDORO;CL;;672;747;1419
4225;MONTEFALCIONE;AV;;1529;1612;3141
4226;MONTEFALCO;PG;;2673;2748;5421
4227;MONTEFALCONE APPENNINO;FM;;189;186;375
4228;MONTEFALCONE DI VAL FORTORE;BN;;618;717;1335
4229;MONTEFALCONE NEL SANNIO;CB;;704;695;1399
4230;MONTEFANO;MC;;1621;1681;3302
4231;MONTEFELCINO;PU;;1270;1239;2509
4232;MONTEFERRANTE;CH;;58;53;111
4233;MONTEFIASCONE;VT;;6316;6704;13020
4234;MONTEFINO;TE;;481;486;967
4235;MONTEFIORE CONCA;RN;;1112;1125;2237
4236;MONTEFIORE DELL'ASO;AP;;960;1020;1980
4237;MONTEFIORINO;MO;;1050;1035;2085
4238;MONTEFLAVIO;RM;;557;638;1195
4239;MONTEFORTE CILENTO;SA;;280;259;539
4240;MONTEFORTE D'ALPONE;VR;;4607;4399;9006
4241;MONTEFORTE IRPINO;AV;;5768;5660;11428
4242;MONTEFORTINO;FM;;539;538;1077
4243;MONTEFRANCO;TR;;628;635;1263
4244;MONTEFREDANE;AV;;1066;1068;2134
4245;MONTEFUSCO;AV;;606;606;1212
4246;MONTEGABBIONE;TR;;551;569;1120
4247;MONTEGALDA;VI;;1669;1707;3376
4248;MONTEGALDELLA;VI;;893;892;1785
4249;MONTEGALLO;AP;;236;212;448
4250;MONTEGIOCO;AL;;151;133;284
4251;MONTEGIORDANO;CS;;769;826;1595
4252;MONTEGIORGIO;FM;;3147;3260;6407
4253;MONTEGRANARO;FM;;6246;6251;12497
4254;MONTEGRIDOLFO;RN;;501;490;991
4255;MONTEGRINO VALTRAVAGLIA;VA;;738;753;1491
4256;MONTEGROSSO D'ASTI;AT;;1157;1133;2290
4257;MONTEGROSSO PIAN LATTE;IM;;58;62;120
4258;MONTEGROTTO TERME;PD;;5462;5900;11362
4259;MONTEIASI;TA;;2595;2782;5377
4260;MONTELABBATE;PU;;3548;3458;7006
4261;MONTELANICO;RM;;1022;1044;2066
4262;MONTELAPIANO;CH;;36;41;77
4263;MONTELEONE D'ORVIETO;TR;;645;724;1369
4264;MONTELEONE DI FERMO;FM;;190;167;357
4265;MONTELEONE DI PUGLIA;FG;;495;464;959
4266;MONTELEONE DI SPOLETO;PG;;287;280;567
4267;MONTELEONE ROCCA DORIA;SS;;49;62;111
4268;MONTELEONE SABINO;RI;;593;604;1197
4269;MONTELEPRE;PA;;2838;3019;5857
4270;MONTELIBRETTI;RM;;2459;2681;5140
4271;MONTELLA;AV;;3582;3785;7367
4272;MONTELLO;BG;;1636;1540;3176
4273;MONTELONGO;CB;;162;153;315
4274;MONTELPARO;FM;;361;352;713
4275;MONTELUPO ALBESE;CN;;231;249;480
4276;MONTELUPO FIORENTINO;FI;;6887;7339;14226
4277;MONTELUPONE;MC;;1685;1707;3392
4278;MONTEMAGGIORE BELSITO;PA;;1435;1555;2990
4279;MONTEMAGNO MONFERRATO;AT;;498;555;1053
4280;MONTEMALE DI CUNEO;CN;;107;107;214
4281;MONTEMARANO;AV;;1306;1330;2636
4282;MONTEMARCIANO;AN;;4835;4919;9754
4283;MONTEMARZINO;AL;;158;153;311
4284;MONTEMESOLA;TA;;1760;1848;3608
4285;MONTEMEZZO;CO;;115;105;220
4286;MONTEMIGNAIO;AR;;265;258;523
4287;MONTEMILETTO;AV;;2521;2546;5067
4288;MONTEMILONE;PZ;;703;699;1402
4289;MONTEMITRO;CB;;149;150;299
4290;MONTEMONACO;AP;;262;266;528
4291;MONTEMURLO;PO;;9442;9658;19100
4292;MONTEMURRO;PZ;;539;581;1120
4293;MONTENARS;UD;;247;236;483
4294;MONTENERO DI BISACCIA;CB;;3094;3097;6191
4295;MONTENERO SABINO;RI;;145;135;280
4296;MONTENERO VAL COCCHIARA;IS;;263;240;503
4297;MONTENERODOMO;CH;;314;290;604
4298;MONTEODORISIO;CH;;1173;1175;2348
4299;MONTEPAONE;CZ;;2798;2816;5614
4300;MONTEPARANO;TA;;1116;1199;2315
4301;MONTEPRANDONE;AP;;6411;6458;12869
4302;MONTEPULCIANO;SI;;6415;6971;13386
4303;MONTERCHI;AR;;846;862;1708
4304;MONTEREALE;AQ;;1135;1065;2200
4305;MONTEREALE VALCELLINA;PN;;2060;2207;4267
4306;MONTERENZIO;BO;;3108;3053;6161
4307;MONTERIGGIONI;SI;;4933;5060;9993
4308;MONTERODUNI;IS;;983;1054;2037
4309;MONTERONI D'ARBIA;SI;;4398;4586;8984
4310;MONTERONI DI LECCE;LE;;6524;6901;13425
4311;MONTEROSI;VT;;2370;2405;4775
4312;MONTEROSSO AL MARE;SP;;637;734;1371
4313;MONTEROSSO ALMO;RG;;1376;1445;2821
4314;MONTEROSSO CALABRO;VV;;758;790;1548
4315;MONTEROSSO GRANA;CN;;279;235;514
4316;MONTEROTONDO;RM;;19906;21154;41060
4317;MONTEROTONDO MARITTIMO;GR;;681;602;1283
4318;MONTERUBBIANO;FM;;998;1043;2041
4319;MONTESANO SALENTINO;LE;;1266;1333;2599
4320;MONTESANO SULLA MARCELLANA;SA;;3098;3177;6275
4321;MONTESARCHIO;BN;;6354;6647;13001
4322;MONTESCAGLIOSO;MT;;4577;4670;9247
4323;MONTESCANO;PV;;201;215;416
4324;MONTESCHENO;VB;;194;186;380
4325;MONTESCUDAIO;PI;;1077;1090;2167
4326;MONTESCUDO - MONTE COLOMBO;RN;;3431;3351;6782
4327;MONTESE;MO;;1610;1612;3222
4328;MONTESEGALE;PV;;139;124;263
4329;MONTESILVANO;PE;;25975;27427;53402
4330;MONTESPERTOLI;FI;;6572;6664;13236
4331;MONTEU DA PO;TO;;429;429;858
4332;MONTEU ROERO;CN;;838;796;1634
4333;MONTEVAGO;AG;;1350;1393;2743
4334;MONTEVARCHI;AR;;11881;12166;24047
4335;MONTEVECCHIA;LC;;1334;1343;2677
4336;MONTEVERDE;AV;;357;357;714
4337;MONTEVERDI MARITTIMO;PI;;384;369;753
4338;MONTEVIALE;VI;;1396;1405;2801
4339;MONTEZEMOLO;CN;;124;101;225
4340;MONTI;SS;;1188;1160;2348
4341;MONTIANO;FC;;839;844;1683
4342;MONTICELLI BRUSATI;BS;;2301;2267;4568
4343;MONTICELLI D'ONGINA;PC;;2515;2591;5106
4344;MONTICELLI PAVESE;PV;;309;322;631
4345;MONTICELLO BRIANZA;LC;;2054;2099;4153
4346;MONTICELLO CONTE OTTO;VI;;4432;4551;8983
4347;MONTICELLO D'ALBA;CN;;1158;1193;2351
4348;MONTICHIARI;BS;;13081;13007;26088
4349;MONTICIANO;SI;;779;755;1534
4350;MONTIERI;GR;;609;564;1173
4351;MONTIGLIO MONFERRATO;AT;;752;764;1516
4352;MONTIGNOSO;MS;;4976;5146;10122
4353;MONTIRONE;BS;;2573;2491;5064
4354;MONTJOVET;AO;;891;875;1766
4355;MONTODINE;CR;;1206;1235;2441
4356;MONTOGGIO;GE;;1015;993;2008
4357;MONTONE;PG;;755;824;1579
4358;MONTOPOLI DI SABINA;RI;;2034;2069;4103
4359;MONTOPOLI IN VAL D'ARNO;PI;;5504;5605;11109
4360;MONTORFANO;CO;;1211;1305;2516
4361;MONTORIO AL VOMANO;TE;;3731;3797;7528
4362;MONTORIO NEI FRENTANI;CB;;185;181;366
4363;MONTORIO ROMANO;RM;;984;955;1939
4364;MONTORO;AV;;9695;9701;19396
4365;MONTORSO VICENTINO;VI;;1562;1469;3031
4366;MONTOTTONE;FM;;415;463;878
4367;MONTRESTA;OR;;222;218;440
4368;MONTU' BECCARIA;PV;;823;795;1618
4369;MONVALLE;VA;;972;967;1939
4370;MONZA;MB;;58584;63400;121984
4371;MONZAMBANO;MN;;2425;2434;4859
4372;MONZUNO;BO;;3210;3148;6358
4373;MORANO CALABRO;CS;;1942;2002;3944
4374;MORANO SUL PO;AL;;640;679;1319
4375;MORANSENGO-TONENGO;AT;*;199;198;397
4376;MORARO;GO;;349;346;695
4377;MORAZZONE;VA;;2103;2175;4278
4378;MORBEGNO;SO;;5941;6286;12227
4379;MORBELLO;AL;;203;186;389
4380;MORCIANO DI LEUCA;LE;;1417;1632;3049
4381;MORCIANO DI ROMAGNA;RN;;3462;3677;7139
4382;MORCONE;BN;;2231;2317;4548
4383;MORDANO;BO;;2343;2248;4591
4384;MORENGO;BG;;1224;1264;2488
4385;MORES;SS;;877;881;1758
4386;MORESCO;FM;;252;272;524
4387;MORETTA;CN;;2029;2049;4078
4388;MORFASSO;PC;;456;432;888
4389;MORGANO;TV;;2220;2208;4428
4390;MORGEX;AO;;1006;1052;2058
4391;MORGONGIORI;OR;;339;322;661
4392;MORI;TN;;4997;5051;10048
4393;MORIAGO DELLA BATTAGLIA;TV;;1401;1382;2783
4394;MORICONE;RM;;1222;1247;2469
4395;MORIGERATI;SA;;297;313;610
4396;MORIMONDO;MI;;514;510;1024
4397;MORINO;AQ;;647;669;1316
4398;MORIONDO TORINESE;TO;;434;419;853
4399;MORLUPO;RM;;4104;4384;8488
4400;MORMANNO;CS;;1298;1373;2671
4401;MORNAGO;VA;;2450;2476;4926
4402;MORNESE;AL;;340;370;710
4403;MORNICO AL SERIO;BG;;1428;1486;2914
4404;MORNICO LOSANA;PV;;294;296;590
4405;MOROLO;FR;;1618;1564;3182
4406;MOROZZO;CN;;1008;992;2000
4407;MORRA DE SANCTIS;AV;;548;585;1133
4408;MORRO D'ALBA;AN;;888;915;1803
4409;MORRO D'ORO;TE;;1738;1822;3560
4410;MORRO REATINO;RI;;167;161;328
4411;MORRONE DEL SANNIO;CB;;274;259;533
4412;MORROVALLE;MC;;4934;4948;9882
4413;MORSANO AL TAGLIAMENTO;PN;;1340;1340;2680
4414;MORSASCO;AL;;292;314;606
4415;MORTARA;PV;;7442;7858;15300
4416;MORTEGLIANO;UD;;2306;2508;4814
4417;MORTERONE;LC;;17;14;31
4418;MORUZZO;UD;;1213;1239;2452
4419;MOSCAZZANO;CR;;367;347;714
4420;MOSCHIANO;AV;;744;809;1553
4421;MOSCIANO SANT'ANGELO;TE;;4539;4549;9088
4422;MOSCUFO;PE;;1566;1526;3092
4423;MOSO IN PASSIRIA/MOOS IN PASSEIER;BZ;;1085;961;2046
4424;MOSSA;GO;;727;795;1522
4425;MOTTA BALUFFI;CR;;401;395;796
4426;MOTTA CAMASTRA;ME;;415;396;811
4427;MOTTA D'AFFERMO;ME;;330;342;672
4428;MOTTA DE' CONTI;VC;;373;368;741
4429;MOTTA DI LIVENZA;TV;;5227;5434;10661
4430;MOTTA MONTECORVINO;FG;;311;344;655
4431;MOTTA SAN GIOVANNI;RC;;2783;2889;5672
4432;MOTTA SANT'ANASTASIA;CT;;5915;6139;12054
4433;MOTTA SANTA LUCIA;CZ;;396;393;789
4434;MOTTA VISCONTI;MI;;3990;4130;8120
4435;MOTTAFOLLONE;CS;;540;554;1094
4436;MOTTALCIATA;BI;;673;659;1332
4437;MOTTEGGIANA;MN;;1281;1177;2458
4438;MOTTOLA;TA;;7525;7894;15419
4439;MOZZAGROGNA;CH;;1179;1247;2426
4440;MOZZANICA;BG;;2187;2162;4349
4441;MOZZATE;CO;;4295;4382;8677
4442;MOZZECANE;VR;;4131;3914;8045
4443;MOZZO;BG;;3591;3720;7311
4444;MUCCIA;MC;;396;427;823
4445;MUGGIA;TS;;6256;6660;12916
4446;MUGGIO';MB;;11525;11988;23513
4447;MUGNANO DEL CARDINALE;AV;;2605;2540;5145
4448;MUGNANO DI NAPOLI;NA;;16797;17781;34578
4449;MULAZZANO;LO;;2917;2917;5834
4450;MULAZZO;MS;;1136;1152;2288
4451;MURA;BS;;387;387;774
4452;MURAVERA;SU;;2524;2647;5171
4453;MURAZZANO;CN;;413;417;830
4454;MURELLO;CN;;473;464;937
4455;MURIALDO;SV;;409;364;773
4456;MURISENGO;AL;;627;664;1291
4457;MURLO;SI;;1237;1171;2408
4458;MURO LECCESE;LE;;2288;2477;4765
4459;MURO LUCANO;PZ;;2470;2490;4960
4460;MUROS;SS;;406;424;830
4461;MUSCOLINE;BS;;1354;1326;2680
4462;MUSEI;SU;;785;727;1512
4463;MUSILE DI PIAVE;VE;;5617;5709;11326
4464;MUSSO;CO;;473;461;934
4465;MUSSOLENTE;VI;;3848;3786;7634
4466;MUSSOMELI;CL;;4837;5174;10011
4467;MUZZANA DEL TURGNANO;UD;;1159;1201;2360
4468;MUZZANO;BI;;269;309;578
4469;NAGO-TORBOLE;TN;;1386;1436;2822
4470;NALLES/NALS;BZ;;1028;1047;2075
4471;NANTO;VI;;1581;1524;3105
4472;NAPOLI;NA;;442655;478487;921142
4473;NARBOLIA;OR;;830;862;1692
4474;NARCAO;SU;;1570;1535;3105
4475;NARDO';LE;;14712;16078;30790
4476;NARDODIPACE;VV;;559;556;1115
4477;NARNI;TR;;8828;9430;18258
4478;NARO;AG;;3418;3633;7051
4479;NARZOLE;CN;;1748;1745;3493
4480;NASINO;SV;;91;83;174
4481;NASO;ME;;1696;1817;3513
4482;NATURNO/NATURNS;BZ;;3017;2998;6015
4483;NAVE;BS;;5262;5378;10640
4484;NAVELLI;AQ;;270;229;499
4485;NAZ-SCIAVES/NATZ-SCHABS;BZ;;1639;1642;3281
4486;NAZZANO;RM;;704;663;1367
4487;NE;GE;;1085;1045;2130
4488;NEBBIUNO;NO;;888;900;1788
4489;NEGRAR DI VALPOLICELLA;VR;;8274;8377;16651
4490;NEIRONE;GE;;455;388;843
4491;NEIVE;CN;;1619;1709;3328
4492;NEMBRO;BG;;5563;5659;11222
4493;NEMI;RM;;950;940;1890
4494;NEMOLI;PZ;;682;722;1404
4495;NEONELI;OR;;296;326;622
4496;NEPI;VT;;4608;4710;9318
4497;NERETO;TE;;2577;2697;5274
4498;NEROLA;RM;;937;960;1897
4499;NERVESA DELLA BATTAGLIA;TV;;3275;3268;6543
4500;NERVIANO;MI;;8261;8667;16928
4501;NESPOLO;RI;;116;75;191
4502;NESSO;CO;;575;588;1163
4503;NETRO;BI;;469;470;939
4504;NETTUNO;RM;;23886;24273;48159
4505;NEVIANO;LE;;2370;2584;4954
4506;NEVIANO DEGLI ARDUINI;PR;;1730;1698;3428
4507;NEVIGLIE;CN;;187;180;367
4508;NIARDO;BS;;963;1005;1968
4509;NIBBIOLA;NO;;403;422;825
4510;NIBIONNO;LC;;1782;1818;3600
4511;NICHELINO;TO;;22455;24003;46458
4512;NICOLOSI;CT;;3789;3807;7596
4513;NICORVO;PV;;136;141;277
4514;NICOSIA;EN;;6261;6616;12877
4515;NICOTERA;VV;;2977;2858;5835
4516;NIELLA BELBO;CN;;181;166;347
4517;NIELLA TANARO;CN;;491;465;956
4518;NIMIS;UD;;1278;1280;2558
4519;NISCEMI;CL;;12465;12714;25179
4520;NISSORIA;EN;;1446;1415;2861
4521;NIZZA DI SICILIA;ME;;1738;1805;3543
4522;NIZZA MONFERRATO;AT;;4875;5219;10094
4523;NOALE;VE;;7803;8325;16128
4524;NOASCA;TO;;56;51;107
4525;NOCARA;CS;;158;167;325
4526;NOCCIANO;PE;;869;856;1725
4527;NOCERA INFERIORE;SA;;21577;22754;44331
4528;NOCERA SUPERIORE;SA;;11727;12115;23842
4529;NOCERA TERINESE;CZ;;2378;2341;4719
4530;NOCERA UMBRA;PG;;2761;2823;5584
4531;NOCETO;PR;;6426;6689;13115
4532;NOCI;BA;;8946;9498;18444
4533;NOCIGLIA;LE;;1008;1151;2159
4534;NOEPOLI;PZ;;367;399;766
4535;NOGARA;VR;;4140;4203;8343
4536;NOGAREDO;TN;;1046;1009;2055
4537;NOGAROLE ROCCA;VR;;2017;1818;3835
4538;NOGAROLE VICENTINO;VI;;617;602;1219
4539;NOICATTARO;BA;;12902;13114;26016
4540;NOLA;NA;;16312;17307;33619
4541;NOLE;TO;;3332;3471;6803
4542;NOLI;SV;;1170;1272;2442
4543;NOMAGLIO;TO;;141;142;283
4544;NOMI;TN;;626;676;1302
4545;NONANTOLA;MO;;7951;8071;16022
4546;NONE;TO;;3876;3954;7830
4547;NONIO;VB;;402;442;844
4548;NORAGUGUME;NU;;141;145;286
4549;NORBELLO;OR;;594;547;1141
4550;NORCIA;PG;;2303;2253;4556
4551;NORMA;LT;;1776;1899;3675
4552;NOSATE;MI;;307;329;636
4553;NOTARESCO;TE;;3150;3237;6387
4554;NOTO;SR;;12037;11868;23905
4555;NOVA LEVANTE/WELSCHNOFEN;BZ;;1050;973;2023
4556;NOVA MILANESE;MB;;11297;11773;23070
4557;NOVA PONENTE/DEUTSCHNOFEN;BZ;;2052;1964;4016
4558;NOVA SIRI;MT;;3382;3326;6708
4559;NOVAFELTRIA;RN;;3450;3512;6962
4560;NOVALEDO;TN;;526;575;1101
4561;NOVALESA;TO;;260;256;516
4562;NOVARA;NO;;49080;52287;101367
4563;NOVARA DI SICILIA;ME;;580;606;1186
4564;NOVATE MEZZOLA;SO;;923;960;1883
4565;NOVATE MILANESE;MI;;9530;10347;19877
4566;NOVE;VI;;2398;2496;4894
4567;NOVEDRATE;CO;;1464;1416;2880
4568;NOVELLA;TN;;1822;1759;3581
4569;NOVELLARA;RE;;6587;6750;13337
4570;NOVELLO;CN;;474;486;960
4571;NOVENTA DI PIAVE;VE;;3433;3519;6952
4572;NOVENTA PADOVANA;PD;;5693;5831;11524
4573;NOVENTA VICENTINA;VI;;4479;4450;8929
4574;NOVI DI MODENA;MO;;4998;5003;10001
4575;NOVI LIGURE;AL;;13217;14232;27449
4576;NOVI VELIA;SA;;1176;1136;2312
4577;NOVIGLIO;MI;;2282;2246;4528
4578;NOVOLI;LE;;3637;4002;7639
4579;NUCETTO;CN;;197;196;393
4580;NUGHEDU SAN NICOLO';SS;;383;380;763
4581;NUGHEDU SANTA VITTORIA;OR;;210;231;441
4582;NULE;SS;;655;638;1293
4583;NULVI;SS;;1307;1341;2648
4584;NUMANA;AN;;1890;1867;3757
4585;NUORO;NU;;16266;17917;34183
4586;NURACHI;OR;;822;870;1692
4587;NURAGUS;SU;;416;426;842
4588;NURALLAO;SU;;606;572;1178
4589;NURAMINIS;SU;;1154;1185;2339
4590;NURECI;OR;;158;162;320
4591;NURRI;SU;;1030;1004;2034
4592;NUS;AO;;1486;1502;2988
4593;NUSCO;AV;;1905;2013;3918
4594;NUVOLENTO;BS;;1897;1968;3865
4595;NUVOLERA;BS;;2340;2355;4695
4596;NUXIS;SU;;713;742;1455
4597;OCCHIEPPO INFERIORE;BI;;1795;1958;3753
4598;OCCHIEPPO SUPERIORE;BI;;1261;1377;2638
4599;OCCHIOBELLO;RO;;5840;6162;12002
4600;OCCIMIANO;AL;;590;652;1242
4601;OCRE;AQ;;554;545;1099
4602;ODALENGO GRANDE;AL;;207;200;407
4603;ODALENGO PICCOLO;AL;;124;115;239
4604;ODERZO;TV;;9723;10319;20042
4605;ODOLO;BS;;931;996;1927
4606;OFENA;AQ;;212;216;428
4607;OFFAGNA;AN;;1031;1006;2037
4608;OFFANENGO;CR;;2929;2998;5927
4609;OFFIDA;AP;;2294;2408;4702
4610;OFFLAGA;BS;;2095;2022;4117
4611;OGGEBBIO;VB;;418;436;854
4612;OGGIONA CON SANTO STEFANO;VA;;2156;2163;4319
4613;OGGIONO;LC;;4473;4570;9043
4614;OGLIANICO;TO;;713;742;1455
4615;OGLIASTRO CILENTO;SA;;1151;1112;2263
4616;OLBIA;SS;;29997;30714;60711
4617;OLCENENGO;VC;;385;402;787
4618;OLDENICO;VC;;108;109;217
4619;OLEGGIO;NO;;6970;7234;14204
4620;OLEGGIO CASTELLO;NO;;1107;1096;2203
4621;OLEVANO DI LOMELLINA;PV;;347;376;723
4622;OLEVANO ROMANO;RM;;3191;3213;6404
4623;OLEVANO SUL TUSCIANO;SA;;3237;3299;6536
4624;OLGIATE COMASCO;CO;;5769;6011;11780
4625;OLGIATE MOLGORA;LC;;3150;3196;6346
4626;OLGIATE OLONA;VA;;6146;6453;12599
4627;OLGINATE;LC;;3445;3493;6938
4628;OLIENA;NU;;3271;3386;6657
4629;OLIVA GESSI;PV;;78;92;170
4630;OLIVADI;CZ;;233;249;482
4631;OLIVERI;ME;;989;1059;2048
4632;OLIVETO CITRA;SA;;1799;1851;3650
4633;OLIVETO LARIO;LC;;609;590;1199
4634;OLIVETO LUCANO;MT;;172;194;366
4635;OLIVETTA SAN MICHELE;IM;;100;101;201
4636;OLIVOLA;AL;;54;60;114
4637;OLLASTRA;OR;;569;575;1144
4638;OLLOLAI;NU;;599;603;1202
4639;OLLOMONT;AO;;84;74;158
4640;OLMEDO;SS;;2081;2053;4134
4641;OLMENETA;CR;;433;472;905
4642;OLMO AL BREMBO;BG;;245;241;486
4643;OLMO GENTILE;AT;;35;35;70
4644;OLTRE IL COLLE;BG;;508;472;980
4645;OLTRESSENDA ALTA;BG;;76;68;144
4646;OLTRONA DI SAN MAMETTE;CO;;1182;1191;2373
4647;OLZAI;NU;;391;383;774
4648;OME;BS;;1537;1615;3152
4649;OMEGNA;VB;;7037;7466;14503
4650;OMIGNANO;SA;;811;821;1632
4651;ONANI';NU;;181;192;373
4652;ONANO;VT;;442;470;912
4653;ONCINO;CN;;50;37;87
4654;ONETA;BG;;283;288;571
4655;ONIFAI;NU;;335;362;697
4656;ONIFERI;NU;;439;434;873
4657;ONO SAN PIETRO;BS;;477;488;965
4658;ONORE;BG;;452;468;920
4659;ONZO;SV;;103;116;219
4660;OPERA;MI;;6788;7364;14152
4661;OPI;AQ;;192;182;374
4662;OPPEANO;VR;;5202;5000;10202
4663;OPPIDO LUCANO;PZ;;1804;1812;3616
4664;OPPIDO MAMERTINA;RC;;2383;2476;4859
4665;ORA/AUER;BZ;;1898;1961;3859
4666;ORANI;NU;;1344;1379;2723
4667;ORATINO;CB;;845;780;1625
4668;ORBASSANO;TO;;11161;11883;23044
4669;ORBETELLO;GR;;6862;7490;14352
4670;ORCIANO PISANO;PI;;301;332;633
4671;ORCO FEGLINO;SV;;471;448;919
4672;ORDONA;FG;;1430;1390;2820
4673;ORERO;GE;;255;248;503
4674;ORGIANO;VI;;1490;1522;3012
4675;ORGOSOLO;NU;;1985;1986;3971
4676;ORIA;BR;;7041;7528;14569
4677;ORICOLA;AQ;;621;630;1251
4678;ORIGGIO;VA;;3958;3981;7939
4679;ORINO;VA;;412;407;819
4680;ORIO AL SERIO;BG;;842;825;1667
4681;ORIO CANAVESE;TO;;380;376;756
4682;ORIO LITTA;LO;;983;1021;2004
4683;ORIOLO;CS;;883;1002;1885
4684;ORIOLO ROMANO;VT;;1853;1875;3728
4685;ORISTANO;OR;;14483;16170;30653
4686;ORMEA;CN;;767;710;1477
4687;ORMELLE;TV;;2285;2230;4515
4688;ORNAGO;MB;;2604;2651;5255
4689;ORNAVASSO;VB;;1668;1686;3354
4690;ORNICA;BG;;73;72;145
4691;OROSEI;NU;;3360;3473;6833
4692;OROTELLI;NU;;949;956;1905
4693;ORRIA;SA;;498;495;993
4694;ORROLI;SU;;1020;997;2017
4695;ORSAGO;TV;;1906;1944;3850
4696;ORSARA BORMIDA;AL;;198;202;400
4697;ORSARA DI PUGLIA;FG;;1256;1265;2521
4698;ORSENIGO;CO;;1319;1330;2649
4699;ORSOGNA;CH;;1762;1891;3653
4700;ORSOMARSO;CS;;565;575;1140
4701;ORTA DI ATELLA;CE;;13483;13635;27118
4702;ORTA NOVA;FG;;8360;8509;16869
4703;ORTA SAN GIULIO;NO;;534;597;1131
4704;ORTACESUS;SU;;461;422;883
4705;ORTE;VT;;4484;4571;9055
4706;ORTELLE;LE;;1063;1171;2234
4707;ORTEZZANO;FM;;368;377;745
4708;ORTIGNANO RAGGIOLO;AR;;437;415;852
4709;ORTISEI/ST. ULRICH;BZ;;2395;2438;4833
4710;ORTONA;CH;;10852;11453;22305
4711;ORTONA DEI MARSI;AQ;;204;230;434
4712;ORTOVERO;SV;;809;790;1599
4713;ORTUCCHIO;AQ;;904;870;1774
4714;ORTUERI;NU;;529;520;1049
4715;ORUNE;NU;;1096;1081;2177
4716;ORVIETO;TR;;9372;10317;19689
4717;ORVINIO;RI;;208;190;398
4718;ORZINUOVI;BS;;6239;6133;12372
4719;ORZIVECCHI;BS;;1225;1205;2430
4720;OSASCO;TO;;563;590;1153
4721;OSASIO;TO;;488;448;936
4722;OSCHIRI;SS;;1534;1517;3051
4723;OSIDDA;NU;;104;115;219
4724;OSIGLIA;SV;;229;214;443
4725;OSILO;SS;;1391;1443;2834
4726;OSIMO;AN;;17167;17625;34792
4727;OSINI;NU;;383;344;727
4728;OSIO SOPRA;BG;;2582;2629;5211
4729;OSIO SOTTO;BG;;6270;6217;12487
4730;OSNAGO;LC;;2312;2430;4742
4731;OSOPPO;UD;;1402;1424;2826
4732;OSPEDALETTI;IM;;1510;1658;3168
4733;OSPEDALETTO;TN;;406;379;785
4734;OSPEDALETTO D'ALPINOLO;AV;;1011;1052;2063
4735;OSPEDALETTO EUGANEO;PD;;2764;2779;5543
4736;OSPEDALETTO LODIGIANO;LO;;1008;945;1953
4737;OSPITALE DI CADORE;BL;;131;136;267
4738;OSPITALETTO;BS;;7485;7178;14663
4739;OSSAGO LODIGIANO;LO;;715;700;1415
4740;OSSANA;TN;;388;434;822
4741;OSSI;SS;;2705;2808;5513
4742;OSSIMO;BS;;724;728;1452
4743;OSSONA;MI;;2198;2145;4343
4744;OSTANA;CN;;49;36;85
4745;OSTELLATO;FE;;2817;2902;5719
4746;OSTIANO;CR;;1338;1361;2699
4747;OSTIGLIA;MN;;3216;3367;6583
4748;OSTRA;AN;;3119;3279;6398
4749;OSTRA VETERE;AN;;1568;1573;3141
4750;OSTUNI;BR;;14530;15772;30302
4751;OTRANTO;LE;;2739;2976;5715
4752;OTRICOLI;TR;;851;873;1724
4753;OTTANA;NU;;1093;1106;2199
4754;OTTATI;SA;;313;318;631
4755;OTTAVIANO;NA;;11366;11698;23064
4756;OTTIGLIO;AL;;298;296;594
4757;OTTOBIANO;PV;;537;536;1073
4758;OTTONE;PC;;252;192;444
4759;OULX;TO;;1687;1606;3293
4760;OVADA;AL;;5202;5671;10873
4761;OVARO;UD;;873;879;1752
4762;OVIGLIO;AL;;594;602;1196
4763;OVINDOLI;AQ;;587;571;1158
4764;OVODDA;NU;;773;763;1536
4765;OYACE;AO;;112;97;209
4766;OZEGNA;TO;;582;594;1176
4767;OZIERI;SS;;4941;4994;9935
4768;OZZANO DELL'EMILIA;BO;;6783;7139;13922
4769;OZZANO MONFERRATO;AL;;683;683;1366
4770;OZZERO;MI;;686;719;1405
4771;PABILLONIS;SU;;1293;1247;2540
4772;PACE DEL MELA;ME;;2938;3073;6011
4773;PACECO;TP;;5305;5591;10896
4774;PACENTRO;AQ;;560;545;1105
4775;PACHINO;SR;;11004;10674;21678
4776;PACIANO;PG;;464;488;952
4777;PADENGHE SUL GARDA;BS;;2313;2460;4773
4778;PADERNA;AL;;101;97;198
4779;PADERNO D'ADDA;LC;;1910;1936;3846
4780;PADERNO DUGNANO;MI;;22880;24210;47090
4781;PADERNO FRANCIACORTA;BS;;1807;1830;3637
4782;PADERNO PONCHIELLI;CR;;684;661;1345
4783;PADOVA;PD;;98507;108144;206651
4784;PADRIA;SS;;299;306;605
4785;PADRU;SS;;1047;1008;2055
4786;PADULA;SA;;2426;2510;4936
4787;PADULI;BN;;1805;1846;3651
4788;PAESANA;CN;;1316;1321;2637
4789;PAESE;TV;;10912;11100;22012
4790;PAGANI;SA;;16838;17634;34472
4791;PAGANICO SABINO;RI;;77;71;148
4792;PAGAZZANO;BG;;1092;1006;2098
4793;PAGLIARA;ME;;551;584;1135
4794;PAGLIETA;CH;;2063;2091;4154
4795;PAGNACCO;UD;;2510;2602;5112
4796;PAGNO;CN;;289;295;584
4797;PAGNONA;LC;;167;161;328
4798;PAGO DEL VALLO DI LAURO;AV;;852;889;1741
4799;PAGO VEIANO;BN;;1143;1161;2304
4800;PAISCO LOVENO;BS;;87;89;176
4801;PAITONE;BS;;1117;1053;2170
4802;PALADINA;BG;;1973;2003;3976
4803;PALAGANO;MO;;1014;1045;2059
4804;PALAGIANELLO;TA;;3694;3933;7627
4805;PALAGIANO;TA;;7898;7890;15788
4806;PALAGONIA;CT;;7791;8011;15802
4807;PALAIA;PI;;2162;2373;4535
4808;PALANZANO;PR;;554;497;1051
4809;PALATA;CB;;762;813;1575
4810;PALAU;SS;;2081;2025;4106
4811;PALAZZAGO;BG;;2299;2193;4492
4812;PALAZZO ADRIANO;PA;;875;974;1849
4813;PALAZZO CANAVESE;TO;;404;435;839
4814;PALAZZO PIGNANO;CR;;1897;1880;3777
4815;PALAZZO SAN GERVASIO;PZ;;2285;2226;4511
4816;PALAZZOLO ACREIDE;SR;;3998;4235;8233
4817;PALAZZOLO DELLO STELLA;UD;;1419;1472;2891
4818;PALAZZOLO SULL'OGLIO;BS;;10022;9915;19937
4819;PALAZZOLO VERCELLESE;VC;;548;557;1105
4820;PALAZZUOLO SUL SENIO;FI;;567;544;1111
4821;PALENA;CH;;625;626;1251
4822;PALERMITI;CZ;;519;556;1075
4823;PALERMO;PA;;303851;331588;635439
4824;PALESTRINA;RM;;10880;11202;22082
4825;PALESTRO;PV;;884;901;1785
4826;PALIANO;FR;;3937;4014;7951
4827;PALIZZI;RC;;965;1028;1993
4828;PALLAGORIO;KR;;509;510;1019
4829;PALLANZENO;VB;;550;552;1102
4830;PALLARE;SV;;451;449;900
4831;PALMA CAMPANIA;NA;;8535;7688;16223
4832;PALMA DI MONTECHIARO;AG;;10288;11221;21509
4833;PALMANOVA;UD;;2592;2696;5288
4834;PALMARIGGI;LE;;686;717;1403
4835;PALMAS ARBOREA;OR;;728;747;1475
4836;PALMI;RC;;8692;9176;17868
4837;PALMIANO;AP;;73;90;163
4838;PALMOLI;CH;;415;389;804
4839;PALO DEL COLLE;BA;;10251;10510;20761
4840;PALOMBARA SABINA;RM;;6392;6490;12882
4841;PALOMBARO;CH;;473;488;961
4842;PALOMONTE;SA;;1891;1863;3754
4843;PALOSCO;BG;;2872;2875;5747
4844;PALU';VR;;609;607;1216
4845;PALU' DEL FERSINA;TN;;86;81;167
4846;PALUDI;CS;;510;504;1014
4847;PALUZZA;UD;;990;1005;1995
4848;PAMPARATO;CN;;142;128;270
4849;PANCALIERI;TO;;963;1029;1992
4850;PANCARANA;PV;;165;150;315
4851;PANCHIA';TN;;392;417;809
4852;PANDINO;CR;;4438;4470;8908
4853;PANETTIERI;CS;;150;166;316
4854;PANICALE;PG;;2591;2741;5332
4855;PANNARANO;BN;;1033;956;1989
4856;PANNI;FG;;346;368;714
4857;PANTELLERIA;TP;;3701;3706;7407
4858;PANTIGLIATE;MI;;2815;2981;5796
4859;PAOLA;CS;;7165;7662;14827
4860;PAOLISI;BN;;1026;981;2007
4861;PAPASIDERO;CS;;325;309;634
4862;PAPOZZE;RO;;673;682;1355
4863;PARABIAGO;MI;;13718;14141;27859
4864;PARABITA;LE;;4158;4583;8741
4865;PARATICO;BS;;2443;2441;4884
4866;PARCINES/PARTSCHINS;BZ;;1927;1960;3887
4867;PARELLA;TO;;190;222;412
4868;PARENTI;CS;;1005;1026;2031
4869;PARETE;CE;;6023;6169;12192
4870;PARETO;AL;;280;237;517
4871;PARGHELIA;VV;;612;649;1261
4872;PARLASCO;LC;;70;66;136
4873;PARMA;PR;;94586;100850;195436
4874;PARODI LIGURE;AL;;318;296;614
4875;PAROLDO;CN;;93;102;195
4876;PAROLISE;AV;;315;323;638
4877;PARONA;PV;;935;914;1849
4878;PARRANO;TR;;242;243;485
4879;PARRE;BG;;1341;1357;2698
4880;PARTANNA;TP;;4879;5053;9932
4881;PARTINICO;PA;;15371;15473;30844
4882;PARUZZARO;NO;;1049;1094;2143
4883;PARZANICA;BG;;186;159;345
4884;PASIAN DI PRATO;UD;;4444;4821;9265
4885;PASIANO DI PORDENONE;PN;;3861;3899;7760
4886;PASPARDO;BS;;301;278;579
4887;PASSERANO MARMORITO;AT;;229;203;432
4888;PASSIGNANO SUL TRASIMENO;PG;;2733;2929;5662
4889;PASSIRANO;BS;;3392;3522;6914
4890;PASTENA;FR;;641;643;1284
4891;PASTORANO;CE;;1468;1431;2899
4892;PASTRENGO;VR;;1541;1547;3088
4893;PASTURANA;AL;;618;668;1286
4894;PASTURO;LC;;982;951;1933
4895;PATERNO;PZ;;1479;1590;3069
4896;PATERNO CALABRO;CS;;696;654;1350
4897;PATERNO';CT;;22158;23381;45539
4898;PATERNOPOLI;AV;;1071;1087;2158
4899;PATRICA;FR;;1518;1553;3071
4900;PATTADA;SS;;1469;1423;2892
4901;PATTI;ME;;6126;6676;12802
4902;PATU';LE;;820;868;1688
4903;PAU;OR;;131;145;276
4904;PAULARO;UD;;1194;1179;2373
4905;PAULI ARBAREI;SU;;282;282;564
4906;PAULILATINO;OR;;1066;1030;2096
4907;PAULLO;MI;;5452;5656;11108
4908;PAUPISI;BN;;710;722;1432
4909;PAVAROLO;TO;;556;592;1148
4910;PAVIA;PV;;33627;36753;70380
4911;PAVIA DI UDINE;UD;;2722;2792;5514
4912;PAVONE CANAVESE;TO;;1776;1859;3635
4913;PAVONE DEL MELLA;BS;;1370;1336;2706
4914;PAVULLO NEL FRIGNANO;MO;;8979;9063;18042
4915;PAZZANO;RC;;249;249;498
4916;PECCIOLI;PI;;2233;2433;4666
4917;PECETTO DI VALENZA;AL;;581;585;1166
4918;PECETTO TORINESE;TO;;1976;2070;4046
4919;PEDARA;CT;;7428;7487;14915
4920;PEDASO;FM;;1341;1470;2811
4921;PEDAVENA;BL;;2117;2211;4328
4922;PEDEMONTE;VI;;341;359;700
4923;PEDEROBBA;TV;;3639;3641;7280
4924;PEDESINA;SO;;19;16;35
4925;PEDIVIGLIANO;CS;;349;395;744
4926;PEDRENGO;BG;;2919;2964;5883
4927;PEGLIO;CO;;92;97;189
4928;PEGLIO;PU;;325;326;651
4929;PEGOGNAGA;MN;;3412;3476;6888
4930;PEIA;BG;;840;880;1720
4931;PEIO;TN;;939;881;1820
4932;PELAGO;FI;;3818;3942;7760
4933;PELLA;NO;;422;472;894
4934;PELLEGRINO PARMENSE;PR;;475;487;962
4935;PELLEZZANO;SA;;5399;5552;10951
4936;PELLIZZANO;TN;;381;391;772
4937;PELUGO;TN;;190;206;396
4938;PENANGO;AT;;217;228;445
4939;PENNA IN TEVERINA;TR;;506;523;1029
4940;PENNA SAN GIOVANNI;MC;;465;506;971
4941;PENNA SANT'ANDREA;TE;;801;834;1635
4942;PENNABILLI;RN;;1301;1328;2629
4943;PENNADOMO;CH;;105;113;218
4944;PENNAPIEDIMONTE;CH;;214;211;425
4945;PENNE;PE;;5583;5785;11368
4946;PENTONE;CZ;;931;1003;1934
4947;PERANO;CH;;748;770;1518
4948;PERAROLO DI CADORE;BL;;180;193;373
4949;PERCA/PERCHA;BZ;;834;822;1656
4950;PERCILE;RM;;114;101;215
4951;PERDASDEFOGU;NU;;890;873;1763
4952;PERDAXIUS;SU;;675;651;1326
4953;PERDIFUMO;SA;;861;897;1758
4954;PERETO;AQ;;327;311;638
4955;PERFUGAS;SS;;1132;1140;2272
4956;PERGINE VALSUGANA;TN;;10457;11026;21483
4957;PERGOLA;PU;;2809;3021;5830
4958;PERINALDO;IM;;409;436;845
4959;PERITO;SA;;411;418;829
4960;PERLEDO;LC;;428;436;864
4961;PERLETTO;CN;;139;121;260
4962;PERLO;CN;;56;52;108
4963;PERLOZ;AO;;225;233;458
4964;PERNUMIA;PD;;1889;1877;3766
4965;PERO;MI;;5681;5796;11477
4966;PEROSA ARGENTINA;TO;;1473;1621;3094
4967;PEROSA CANAVESE;TO;;253;272;525
4968;PERRERO;TO;;315;268;583
4969;PERSICO DOSIMO;CR;;1637;1642;3279
4970;PERTENGO;VC;;147;158;305
4971;PERTICA ALTA;BS;;293;264;557
4972;PERTICA BASSA;BS;;282;294;576
4973;PERTOSA;SA;;318;334;652
4974;PERTUSIO;TO;;372;380;752
4975;PERUGIA;PG;;77973;84389;162362
4976;PESARO;PU;;46048;49622;95670
4977;PESCAGLIA;LU;;1652;1654;3306
4978;PESCANTINA;VR;;8664;8762;17426
4979;PESCARA;PE;;56234;62758;118992
4980;PESCAROLO ED UNITI;CR;;756;760;1516
4981;PESCASSEROLI;AQ;;1079;997;2076
4982;PESCATE;LC;;1069;1080;2149
4983;PESCHE;IS;;756;761;1517
4984;PESCHICI;FG;;2155;2150;4305
4985;PESCHIERA BORROMEO;MI;;11812;12272;24084
4986;PESCHIERA DEL GARDA;VR;;5272;5639;10911
4987;PESCIA;PT;;9369;9854;19223
4988;PESCINA;AQ;;1861;1901;3762
4989;PESCO SANNITA;BN;;890;979;1869
4990;PESCOCOSTANZO;AQ;;567;524;1091
4991;PESCOLANCIANO;IS;;403;407;810
4992;PESCOPAGANO;PZ;;835;867;1702
4993;PESCOPENNATARO;IS;;120;113;233
4994;PESCOROCCHIANO;RI;;982;946;1928
4995;PESCOSANSONESCO;PE;;228;243;471
4996;PESCOSOLIDO;FR;;738;724;1462
4997;PESSANO CON BORNAGO;MI;;4448;4535;8983
4998;PESSINA CREMONESE;CR;;295;278;573
4999;PESSINETTO;TO;;317;291;608
5000;PETACCIATO;CB;;1763;1731;3494
5001;PETILIA POLICASTRO;KR;;4366;4348;8714
5002;PETINA;SA;;522;515;1037
5003;PETRALIA SOPRANA;PA;;1473;1519;2992
5004;PETRALIA SOTTANA;PA;;1156;1336;2492
5005;PETRELLA SALTO;RI;;564;472;1036
5006;PETRELLA TIFERNINA;CB;;509;535;1044
5007;PETRIANO;PU;;1373;1353;2726
5008;PETRIOLO;MC;;925;918;1843
5009;PETRITOLI;FM;;1057;1099;2156
5010;PETRIZZI;CZ;;508;520;1028
5011;PETRONA';CZ;;1157;1247;2404
5012;PETROSINO;TP;;4105;3857;7962
5013;PETRURO IRPINO;AV;;149;149;298
5014;PETTENASCO;NO;;663;678;1341
5015;PETTINENGO;BI;;743;727;1470
5016;PETTINEO;ME;;598;637;1235
5017;PETTORANELLO DEL MOLISE;IS;;247;202;449
5018;PETTORANO SUL GIZIO;AQ;;688;636;1324
5019;PETTORAZZA GRIMANI;RO;;761;722;1483
5020;PEVERAGNO;CN;;2707;2787;5494
5021;PEZZANA;VC;;630;641;1271
5022;PEZZAZE;BS;;734;714;1448
5023;PEZZOLO VALLE UZZONE;CN;;153;157;310
5024;PIACENZA;PC;;49428;52936;102364
5025;PIACENZA D'ADIGE;PD;;621;610;1231
5026;PIADENA DRIZZONA;CR;;1987;1980;3967
5027;PIAGGINE;SA;;567;613;1180
5028;PIAN CAMUNO;BS;;2389;2344;4733
5029;PIANA CRIXIA;SV;;377;383;760
5030;PIANA DEGLI ALBANESI;PA;;2869;2834;5703
5031;PIANA DI MONTE VERNA;CE;;1019;1076;2095
5032;PIANCASTAGNAIO;SI;;1927;2041;3968
5033;PIANCOGNO;BS;;2410;2332;4742
5034;PIANDIMELETO;PU;;1015;1046;2061
5035;PIANE CRATI;CS;;667;711;1378
5036;PIANELLA;PE;;4223;4301;8524
5037;PIANELLO DEL LARIO;CO;;515;532;1047
5038;PIANELLO VAL TIDONE;PC;;1070;1113;2183
5039;PIANENGO;CR;;1277;1251;2528
5040;PIANEZZA;TO;;7539;7910;15449
5041;PIANEZZE;VI;;1061;1102;2163
5042;PIANFEI;CN;;1073;1027;2100
5043;PIANICO;BG;;716;720;1436
5044;PIANIGA;VE;;6046;6191;12237
5045;PIANO DI SORRENTO;NA;;6021;6465;12486
5046;PIANOPOLI;CZ;;1258;1281;2539
5047;PIANORO;BO;;8594;8992;17586
5048;PIANSANO;VT;;967;919;1886
5049;PIANTEDO;SO;;702;713;1415
5050;PIARIO;BG;;514;492;1006
5051;PIASCO;CN;;1348;1348;2696
5052;PIATEDA;SO;;991;1082;2073
5053;PIATTO;BI;;235;243;478
5054;PIAZZA AL SERCHIO;LU;;1032;1112;2144
5055;PIAZZA ARMERINA;EN;;10139;10594;20733
5056;PIAZZA BREMBANA;BG;;585;610;1195
5057;PIAZZATORRE;BG;;195;194;389
5058;PIAZZOLA SUL BRENTA;PD;;5486;5607;11093
5059;PIAZZOLO;BG;;40;47;87
5060;PICCIANO;PE;;636;651;1287
5061;PICERNO;PZ;;2852;2812;5664
5062;PICINISCO;FR;;551;579;1130
5063;PICO;FR;;1305;1345;2650
5064;PIEA;AT;;264;258;522
5065;PIEDICAVALLO;BI;;92;82;174
5066;PIEDIMONTE ETNEO;CT;;1949;1977;3926
5067;PIEDIMONTE MATESE;CE;;4968;5340;10308
5068;PIEDIMONTE SAN GERMANO;FR;;3150;3160;6310
5069;PIEDIMULERA;VB;;741;724;1465
5070;PIEGARO;PG;;1652;1737;3389
5071;PIENZA;SI;;949;1058;2007
5072;PIERANICA;CR;;569;551;1120
5073;PIETRA DE' GIORGI;PV;;380;375;755
5074;PIETRA LIGURE;SV;;3958;4368;8326
5075;PIETRA MARAZZI;AL;;419;448;867
5076;PIETRABBONDANTE;IS;;331;304;635
5077;PIETRABRUNA;IM;;229;224;453
5078;PIETRACAMELA;TE;;127;95;222
5079;PIETRACATELLA;CB;;606;643;1249
5080;PIETRACUPA;CB;;99;108;207
5081;PIETRADEFUSI;AV;;958;1007;1965
5082;PIETRAFERRAZZANA;CH;;62;68;130
5083;PIETRAFITTA;CS;;574;592;1166
5084;PIETRAGALLA;PZ;;1916;1947;3863
5085;PIETRALUNGA;PG;;962;1028;1990
5086;PIETRAMELARA;CE;;2204;2311;4515
5087;PIETRAMONTECORVINO;FG;;1220;1291;2511
5088;PIETRANICO;PE;;206;229;435
5089;PIETRAPAOLA;CS;;480;541;1021
5090;PIETRAPERTOSA;PZ;;442;482;924
5091;PIETRAPERZIA;EN;;3009;3378;6387
5092;PIETRAPORZIO;CN;;38;35;73
5093;PIETRAROJA;BN;;236;276;512
5094;PIETRARUBBIA;PU;;314;288;602
5095;PIETRASANTA;LU;;10863;12203;23066
5096;PIETRASTORNINA;AV;;740;715;1455
5097;PIETRAVAIRANO;CE;;1393;1440;2833
5098;PIETRELCINA;BN;;1441;1456;2897
5099;PIEVE A NIEVOLE;PT;;4416;4704;9120
5100;PIEVE ALBIGNOLA;PV;;411;425;836
5101;PIEVE D'OLMI;CR;;609;624;1233
5102;PIEVE DEL CAIRO;PV;;865;896;1761
5103;PIEVE DEL GRAPPA;TV;;3211;3381;6592
5104;PIEVE DI BONO-PREZZO;TN;;709;719;1428
5105;PIEVE DI CADORE;BL;;1770;1911;3681
5106;PIEVE DI CENTO;BO;;3526;3627;7153
5107;PIEVE DI SOLIGO;TV;;5753;5927;11680
5108;PIEVE DI TECO;IM;;650;672;1322
5109;PIEVE EMANUELE;MI;;7839;7832;15671
5110;PIEVE FISSIRAGA;LO;;881;876;1757
5111;PIEVE FOSCIANA;LU;;1139;1124;2263
5112;PIEVE LIGURE;GE;;1198;1231;2429
5113;PIEVE PORTO MORONE;PV;;1297;1271;2568
5114;PIEVE SAN GIACOMO;CR;;781;804;1585
5115;PIEVE SANTO STEFANO;AR;;1481;1513;2994
5116;PIEVE TESINO;TN;;331;321;652
5117;PIEVE TORINA;MC;;627;641;1268
5118;PIEVE VERGONTE;VB;;1178;1275;2453
5119;PIEVEPELAGO;MO;;1075;1067;2142
5120;PIGLIO;FR;;2166;2216;4382
5121;PIGNA;IM;;372;391;763
5122;PIGNATARO INTERAMNA;FR;;1204;1243;2447
5123;PIGNATARO MAGGIORE;CE;;2800;2961;5761
5124;PIGNOLA;PZ;;3362;3421;6783
5125;PIGNONE;SP;;252;267;519
5126;PIGRA;CO;;123;125;248
5127;PILA;VC;;83;61;144
5128;PIMENTEL;SU;;590;541;1131
5129;PIMONTE;NA;;2934;2934;5868
5130;PINAROLO PO;PV;;816;872;1688
5131;PINASCA;TO;;1367;1486;2853
5132;PINCARA;RO;;547;548;1095
5133;PINEROLO;TO;;16881;18559;35440
5134;PINETO;TE;;7015;7523;14538
5135;PINO D'ASTI;AT;;109;96;205
5136;PINO TORINESE;TO;;4006;4327;8333
5137;PINZANO AL TAGLIAMENTO;PN;;728;770;1498
5138;PINZOLO;TN;;1506;1555;3061
5139;PIOBBICO;PU;;885;913;1798
5140;PIOBESI D'ALBA;CN;;700;703;1403
5141;PIOBESI TORINESE;TO;;1852;1966;3818
5142;PIODE;VC;;91;97;188
5143;PIOLTELLO;MI;;18152;18050;36202
5144;PIOMBINO;LI;;15582;16722;32304
5145;PIOMBINO DESE;PD;;4785;4695;9480
5146;PIORACO;MC;;488;504;992
5147;PIOSSASCO;TO;;8854;9233;18087
5148;PIOVA' MASSAIA;AT;;285;296;581
5149;PIOVE DI SACCO;PD;;9773;10365;20138
5150;PIOVENE ROCCHETTE;VI;;4046;4114;8160
5151;PIOZZANO;PC;;316;264;580
5152;PIOZZO;CN;;490;494;984
5153;PIRAINO;ME;;1857;1941;3798
5154;PISA;PI;;42767;46235;89002
5155;PISANO;NO;;376;403;779
5156;PISCINA;TO;;1622;1697;3319
5157;PISCINAS;SU;;395;421;816
5158;PISCIOTTA;SA;;1218;1229;2447
5159;PISOGNE;BS;;3865;3938;7803
5160;PISONIANO;RM;;368;373;741
5161;PISTICCI;MT;;8329;8507;16836
5162;PISTOIA;PT;;43009;46484;89493
5163;PITIGLIANO;GR;;1716;1892;3608
5164;PIUBEGA;MN;;859;852;1711
5165;PIURO;SO;;944;957;1901
5166;PIVERONE;TO;;624;678;1302
5167;PIZZALE;PV;;344;347;691
5168;PIZZIGHETTONE;CR;;3079;3194;6273
5169;PIZZO;VV;;4359;4519;8878
5170;PIZZOFERRATO;CH;;506;472;978
5171;PIZZOLI;AQ;;2244;2054;4298
5172;PIZZONE;IS;;166;149;315
5173;PIZZONI;VV;;488;512;1000
5174;PLACANICA;RC;;504;539;1043
5175;PLATACI;CS;;342;333;675
5176;PLATANIA;CZ;;945;1003;1948
5177;PLATI';RC;;1891;1845;3736
5178;PLAUS/PLAUS;BZ;;383;357;740
5179;PLESIO;CO;;426;391;817
5180;PLOAGHE;SS;;2182;2168;4350
5181;PLODIO;SV;;316;306;622
5182;POCAPAGLIA;CN;;1625;1662;3287
5183;POCENIA;UD;;1172;1191;2363
5184;PODENZANA;MS;;1051;1067;2118
5185;PODENZANO;PC;;4464;4561;9025
5186;POFI;FR;;1977;1995;3972
5187;POGGIARDO;LE;;2797;3057;5854
5188;POGGIBONSI;SI;;13951;14625;28576
5189;POGGIO A CAIANO;PO;;4889;5067;9956
5190;POGGIO BUSTONE;RI;;1003;972;1975
5191;POGGIO CATINO;RI;;605;636;1241
5192;POGGIO IMPERIALE;FG;;1262;1249;2511
5193;POGGIO MIRTETO;RI;;3017;3128;6145
5194;POGGIO MOIANO;RI;;1419;1399;2818
5195;POGGIO NATIVO;RI;;1357;1212;2569
5196;POGGIO PICENZE;AQ;;499;537;1036
5197;POGGIO RENATICO;FE;;4790;4960;9750
5198;POGGIO RUSCO;MN;;3250;3228;6478
5199;POGGIO SAN LORENZO;RI;;289;256;545
5200;POGGIO SAN MARCELLO;AN;;329;325;654
5201;POGGIO SAN VICINO;MC;;106;119;225
5202;POGGIO SANNITA;IS;;294;290;584
5203;POGGIO TORRIANA;RN;;2581;2580;5161
5204;POGGIODOMO;PG;;55;44;99
5205;POGGIOFIORITO;CH;;403;424;827
5206;POGGIOMARINO;NA;;10999;11012;22011
5207;POGGIOREALE;TP;;674;679;1353
5208;POGGIORSINI;BA;;650;641;1291
5209;POGGIRIDENTI;SO;;879;940;1819
5210;POGLIANO MILANESE;MI;;4176;4217;8393
5211;POGNANA LARIO;CO;;327;340;667
5212;POGNANO;BG;;794;766;1560
5213;POGNO;NO;;649;701;1350
5214;POIRINO;TO;;5059;5120;10179
5215;POJANA MAGGIORE;VI;;2140;2131;4271
5216;POLAVENO;BS;;1241;1223;2464
5217;POLCENIGO;PN;;1532;1591;3123
5218;POLESELLA;RO;;1860;1880;3740
5219;POLESINE ZIBELLO;PR;;1525;1568;3093
5220;POLI;RM;;1119;1141;2260
5221;POLIA;VV;;399;441;840
5222;POLICORO;MT;;8633;9052;17685
5223;POLIGNANO A MARE;BA;;8673;9007;17680
5224;POLINAGO;MO;;801;781;1582
5225;POLINO;TR;;109;98;207
5226;POLISTENA;RC;;4843;5117;9960
5227;POLIZZI GENEROSA;PA;;1430;1545;2975
5228;POLLA;SA;;2527;2647;5174
5229;POLLEIN;AO;;744;763;1507
5230;POLLENA TROCCHIA;NA;;6283;6693;12976
5231;POLLENZA;MC;;3130;3177;6307
5232;POLLICA;SA;;1083;1095;2178
5233;POLLINA;PA;;1398;1456;2854
5234;POLLONE;BI;;1004;1029;2033
5235;POLLUTRI;CH;;1007;1050;2057
5236;POLONGHERA;CN;;538;574;1112
5237;POLPENAZZE DEL GARDA;BS;;1355;1350;2705
5238;POLVERARA;PD;;1659;1714;3373
5239;POLVERIGI;AN;;2283;2318;4601
5240;POMARANCE;PI;;2658;2732;5390
5241;POMARETTO;TO;;471;500;971
5242;POMARICO;MT;;1903;1929;3832
5243;POMARO MONFERRATO;AL;;152;161;313
5244;POMAROLO;TN;;1260;1196;2456
5245;POMBIA;NO;;1060;1058;2118
5246;POMEZIA;RM;;31984;32021;64005
5247;POMIGLIANO D'ARCO;NA;;19098;20664;39762
5248;POMPEI;NA;;11567;12531;24098
5249;POMPEIANA;IM;;415;437;852
5250;POMPIANO;BS;;1870;1874;3744
5251;POMPONESCO;MN;;812;859;1671
5252;POMPU;OR;;116;99;215
5253;PONCARALE;BS;;2568;2593;5161
5254;PONDERANO;BI;;1805;1935;3740
5255;PONNA;CO;;119;111;230
5256;PONSACCO;PI;;7611;7966;15577
5257;PONSO;PD;;1231;1166;2397
5258;PONT CANAVESE;TO;;1488;1599;3087
5259;PONT-SAINT-MARTIN;AO;;1688;1865;3553
5260;PONTASSIEVE;FI;;9904;10400;20304
5261;PONTBOSET;AO;;92;79;171
5262;PONTE;BN;;1182;1256;2438
5263;PONTE BUGGIANESE;PT;;4275;4520;8795
5264;PONTE DELL'OLIO;PC;;2274;2340;4614
5265;PONTE DI LEGNO;BS;;846;901;1747
5266;PONTE DI PIAVE;TV;;4205;4081;8286
5267;PONTE GARDENA/WAIDBRUCK;BZ;;115;87;202
5268;PONTE IN VALTELLINA;SO;;1119;1136;2255
5269;PONTE LAMBRO;CO;;2099;2143;4242
5270;PONTE NELLE ALPI;BL;;3917;4013;7930
5271;PONTE NIZZA;PV;;379;393;772
5272;PONTE NOSSA;BG;;847;872;1719
5273;PONTE SAN NICOLO';PD;;6418;6889;13307
5274;PONTE SAN PIETRO;BG;;5713;5768;11481
5275;PONTEBBA;UD;;652;670;1322
5276;PONTECAGNANO FAIANO;SA;;12705;13134;25839
5277;PONTECCHIO POLESINE;RO;;1129;1085;2214
5278;PONTECHIANALE;CN;;95;92;187
5279;PONTECORVO;FR;;6106;6332;12438
5280;PONTECURONE;AL;;1731;1696;3427
5281;PONTEDASSIO;IM;;1177;1164;2341
5282;PONTEDERA;PI;;14487;14797;29284
5283;PONTELANDOLFO;BN;;979;1042;2021
5284;PONTELATONE;CE;;757;786;1543
5285;PONTELONGO;PD;;1828;1813;3641
5286;PONTENURE;PC;;3203;3308;6511
5287;PONTERANICA;BG;;3325;3357;6682
5288;PONTESTURA;AL;;641;671;1312
5289;PONTEVICO;BS;;3283;3708;6991
5290;PONTEY;AO;;403;392;795
5291;PONTI;AL;;278;266;544
5292;PONTI SUL MINCIO;MN;;1113;1162;2275
5293;PONTIDA;BG;;1663;1613;3276
5294;PONTINIA;LT;;7447;7466;14913
5295;PONTINVREA;SV;;422;398;820
5296;PONTIROLO NUOVO;BG;;2499;2447;4946
5297;PONTOGLIO;BS;;3459;3443;6902
5298;PONTREMOLI;MS;;3302;3629;6931
5299;PONZA;LT;;1729;1576;3305
5300;PONZANO DI FERMO;FM;;835;806;1641
5301;PONZANO MONFERRATO;AL;;156;159;315
5302;PONZANO ROMANO;RM;;609;552;1161
5303;PONZANO VENETO;TV;;6412;6569;12981
5304;PONZONE;AL;;526;473;999
5305;POPOLI TERME;PE;;2296;2461;4757
5306;POPPI;AR;;2963;2916;5879
5307;PORANO;TR;;909;995;1904
5308;PORCARI;LU;;4340;4449;8789
5309;PORCIA;PN;;7270;7715;14985
5310;PORDENONE;PN;;24818;26799;51617
5311;PORLEZZA;CO;;2371;2449;4820
5312;PORNASSIO;IM;;385;271;656
5313;PORPETTO;UD;;1230;1245;2475
5314;PORTACOMARO;AT;;947;979;1926
5315;PORTALBERA;PV;;708;741;1449
5316;PORTE;TO;;547;532;1079
5317;PORTE DI RENDENA;TN;;893;889;1782
5318;PORTICI;NA;;24687;27813;52500
5319;PORTICO DI CASERTA;CE;;3826;3942;7768
5320;PORTICO E SAN BENEDETTO;FC;;368;367;735
5321;PORTIGLIOLA;RC;;530;561;1091
5322;PORTO AZZURRO;LI;;1870;1770;3640
5323;PORTO CERESIO;VA;;1385;1453;2838
5324;PORTO CESAREO;LE;;3163;3137;6300
5325;PORTO EMPEDOCLE;AG;;7679;7982;15661
5326;PORTO MANTOVANO;MN;;8119;8379;16498
5327;PORTO RECANATI;MC;;6315;6009;12324
5328;PORTO SAN GIORGIO;FM;;7419;8280;15699
5329;PORTO SANT'ELPIDIO;FM;;12601;13156;25757
5330;PORTO TOLLE;RO;;4501;4634;9135
5331;PORTO TORRES;SS;;10454;10876;21330
5332;PORTO VALTRAVAGLIA;VA;;1078;1188;2266
5333;PORTO VIRO;RO;;6735;7047;13782
5334;PORTOBUFFOLE';TV;;361;375;736
5335;PORTOCANNONE;CB;;1187;1152;2339
5336;PORTOFERRAIO;LI;;5768;6096;11864
5337;PORTOFINO;GE;;187;182;369
5338;PORTOGRUARO;VE;;11789;12699;24488
5339;PORTOMAGGIORE;FE;;5784;5800;11584
5340;PORTOPALO DI CAPO PASSERO;SR;;1933;1865;3798
5341;PORTOSCUSO;SU;;2405;2464;4869
5342;PORTOVENERE;SP;;1661;1649;3310
5343;PORTULA;BI;;563;570;1133
5344;POSADA;NU;;1541;1479;3020
5345;POSINA;VI;;288;270;558
5346;POSITANO;SA;;1849;1923;3772
5347;POSSAGNO;TV;;1132;1092;2224
5348;POSTA;RI;;307;259;566
5349;POSTA FIBRENO;FR;;516;544;1060
5350;POSTAL/BURGSTALL;BZ;;963;1001;1964
5351;POSTALESIO;SO;;332;327;659
5352;POSTIGLIONE;SA;;1002;996;1998
5353;POSTUA;VC;;285;276;561
5354;POTENZA;PZ;;31168;33682;64850
5355;POTENZA PICENA;MC;;7575;7940;15515
5356;POVE DEL GRAPPA;VI;;1541;1619;3160
5357;POVEGLIANO;TV;;2559;2545;5104
5358;POVEGLIANO VERONESE;VR;;3608;3722;7330
5359;POVIGLIO;RE;;3557;3539;7096
5360;POVOLETTO;UD;;2678;2732;5410
5361;POZZAGLIA SABINA;RI;;154;154;308
5362;POZZAGLIO ED UNITI;CR;;730;713;1443
5363;POZZALLO;RG;;9409;9588;18997
5364;POZZILLI;IS;;1080;1094;2174
5365;POZZO D'ADDA;MI;;3286;3186;6472
5366;POZZOL GROPPO;AL;;152;144;296
5367;POZZOLENGO;BS;;1789;1767;3556
5368;POZZOLEONE;VI;;1451;1322;2773
5369;POZZOLO FORMIGARO;AL;;2270;2243;4513
5370;POZZOMAGGIORE;SS;;1191;1225;2416
5371;POZZONOVO;PD;;1713;1769;3482
5372;POZZUOLI;NA;;37464;39488;76952
5373;POZZUOLO DEL FRIULI;UD;;3360;3546;6906
5374;POZZUOLO MARTESANA;MI;;4174;4369;8543
5375;PRADALUNGA;BG;;2248;2270;4518
5376;PRADAMANO;UD;;1697;1825;3522
5377;PRADLEVES;CN;;126;115;241
5378;PRAGELATO;TO;;402;333;735
5379;PRAIA A MARE;CS;;3020;3398;6418
5380;PRAIANO;SA;;998;1011;2009
5381;PRALBOINO;BS;;1448;1355;2803
5382;PRALI;TO;;131;118;249
5383;PRALORMO;TO;;941;958;1899
5384;PRALUNGO;BI;;1113;1177;2290
5385;PRAMAGGIORE;VE;;2364;2357;4721
5386;PRAMOLLO;TO;;119;103;222
5387;PRAROLO;VC;;352;356;708
5388;PRAROSTINO;TO;;639;616;1255
5389;PRASCO;AL;;242;237;479
5390;PRASCORSANO;TO;;371;355;726
5391;PRATA CAMPORTACCIO;SO;;1464;1454;2918
5392;PRATA D'ANSIDONIA;AQ;;228;225;453
5393;PRATA DI PORDENONE;PN;;4204;4146;8350
5394;PRATA DI PRINCIPATO ULTRA;AV;;1416;1365;2781
5395;PRATA SANNITA;CE;;669;725;1394
5396;PRATELLA;CE;;727;730;1457
5397;PRATIGLIONE;TO;;225;233;458
5398;PRATO;PO;;95463;99750;195213
5399;PRATO ALLO STELVIO/PRAD AM STILFSER JOCH;BZ;;1876;1858;3734
5400;PRATO CARNICO;UD;;433;420;853
5401;PRATO SESIA;NO;;921;928;1849
5402;PRATOLA PELIGNA;AQ;;3499;3633;7132
5403;PRATOLA SERRA;AV;;1785;1858;3643
5404;PRATOVECCHIO STIA;AR;;2669;2770;5439
5405;PRAVISDOMINI;PN;;1691;1719;3410
5406;PRAY;BI;;949;1059;2008
5407;PRAZZO;CN;;90;87;177
5408;PRE'-SAINT-DIDIER;AO;;515;462;977
5409;PRECENICCO;UD;;725;708;1433
5410;PRECI;PG;;340;343;683
5411;PREDAIA;TN;;3398;3417;6815
5412;PREDAPPIO;FC;;3141;3096;6237
5413;PREDAZZO;TN;;2208;2294;4502
5414;PREDOI/PRETTAU;BZ;;265;263;528
5415;PREDORE;BG;;906;940;1846
5416;PREDOSA;AL;;929;966;1895
5417;PREGANZIOL;TV;;8268;8531;16799
5418;PREGNANA MILANESE;MI;;3623;3663;7286
5419;PRELA';IM;;249;233;482
5420;PREMANA;LC;;1108;1070;2178
5421;PREMARIACCO;UD;;1943;2030;3973
5422;PREMENO;VB;;378;386;764
5423;PREMIA;VB;;271;273;544
5424;PREMILCUORE;FC;;353;355;708
5425;PREMOLO;BG;;562;499;1061
5426;PREMOSELLO-CHIOVENDA;VB;;885;953;1838
5427;PREONE;UD;;129;123;252
5428;PREPOTTO;UD;;359;354;713
5429;PRESEGLIE;BS;;767;698;1465
5430;PRESENZANO;CE;;843;815;1658
5431;PRESEZZO;BG;;2352;2450;4802
5432;PRESICCE-ACQUARICA;LE;;4514;4888;9402
5433;PRESSANA;VR;;1306;1204;2510
5434;PRETORO;CH;;419;446;865
5435;PREVALLE;BS;;3425;3390;6815
5436;PREZZA;AQ;;438;448;886
5437;PRIERO;CN;;264;261;525
5438;PRIGNANO CILENTO;SA;;538;532;1070
5439;PRIGNANO SULLA SECCHIA;MO;;1918;1845;3763
5440;PRIMALUNA;LC;;1103;1143;2246
5441;PRIMIERO SAN MARTINO DI CASTROZZA;TN;;2557;2625;5182
5442;PRIOCCA;CN;;998;1027;2025
5443;PRIOLA;CN;;328;330;658
5444;PRIOLO GARGALLO;SR;;5663;5790;11453
5445;PRIVERNO;LT;;6800;6992;13792
5446;PRIZZI;PA;;2044;2220;4264
5447;PROCENO;VT;;281;247;528
5448;PROCIDA;NA;;5039;5121;10160
5449;PROPATA;GE;;66;47;113
5450;PROSERPIO;CO;;463;477;940
5451;PROSSEDI;LT;;596;575;1171
5452;PROVAGLIO D'ISEO;BS;;3536;3625;7161
5453;PROVAGLIO VAL SABBIA;BS;;456;428;884
5454;PROVES/PROVEIS;BZ;;149;109;258
5455;PROVVIDENTI;CB;;58;49;107
5456;PRUNETTO;CN;;206;203;409
5457;PUEGNAGO DEL GARDA;BS;;1707;1757;3464
5458;PUGLIANELLO;BN;;646;658;1304
5459;PULA;CA;;3581;3525;7106
5460;PULFERO;UD;;442;413;855
5461;PULSANO;TA;;5539;5665;11204
5462;PUMENENGO;BG;;846;833;1679
5463;PUSIANO;CO;;648;686;1334
5464;PUTIFIGARI;SS;;348;343;691
5465;PUTIGNANO;BA;;12775;13312;26087
5466;QUADRELLE;AV;;899;903;1802
5467;QUADRI;CH;;337;380;717
5468;QUAGLIUZZO;TO;;173;160;333
5469;QUALIANO;NA;;12277;12446;24723
5470;QUARANTI;AT;;80;70;150
5471;QUAREGNA CERRETO;BI;;1010;1021;2031
5472;QUARGNENTO;AL;;654;693;1347
5473;QUARNA SOPRA;VB;;116;136;252
5474;QUARNA SOTTO;VB;;184;181;365
5475;QUARONA;VC;;1770;2034;3804
5476;QUARRATA;PT;;13110;13685;26795
5477;QUART;AO;;2051;2038;4089
5478;QUARTO;NA;;20273;21017;41290
5479;QUARTO D'ALTINO;VE;;3905;4095;8000
5480;QUARTU SANT'ELENA;CA;;33694;35159;68853
5481;QUARTUCCIU;CA;;6351;6559;12910
5482;QUASSOLO;TO;;163;176;339
5483;QUATTORDIO;AL;;732;765;1497
5484;QUATTRO CASTELLA;RE;;6405;6718;13123
5485;QUILIANO;SV;;3347;3555;6902
5486;QUINCINETTO;TO;;489;503;992
5487;QUINDICI;AV;;924;901;1825
5488;QUINGENTOLE;MN;;509;549;1058
5489;QUINTANO;CR;;449;445;894
5490;QUINTO DI TREVISO;TV;;4905;5040;9945
5491;QUINTO VERCELLESE;VC;;192;199;391
5492;QUINTO VICENTINO;VI;;2894;2974;5868
5493;QUINZANO D'OGLIO;BS;;3097;3080;6177
5494;QUISTELLO;MN;;2605;2715;5320
5495;RABBI;TN;;692;653;1345
5496;RACALE;LE;;5184;5559;10743
5497;RACALMUTO;AG;;3725;3920;7645
5498;RACCONIGI;CN;;4749;4873;9622
5499;RACCUJA;ME;;436;453;889
5500;RACINES/RATSCHINGS;BZ;;2348;2232;4580
5501;RADDA IN CHIANTI;SI;;718;752;1470
5502;RADDUSA;CT;;1389;1459;2848
5503;RADICOFANI;SI;;510;555;1065
5504;RADICONDOLI;SI;;480;445;925
5505;RAFFADALI;AG;;5866;6318;12184
5506;RAGALNA;CT;;2133;2051;4184
5507;RAGOGNA;UD;;1380;1432;2812
5508;RAGUSA;RG;;35437;37342;72779
5509;RAIANO;AQ;;1263;1368;2631
5510;RAMACCA;CT;;5203;5141;10344
5511;RANCIO VALCUVIA;VA;;454;452;906
5512;RANCO;VA;;624;627;1251
5513;RANDAZZO;CT;;4938;5375;10313
5514;RANICA;BG;;2870;3009;5879
5515;RANZANICO;BG;;627;612;1239
5516;RANZO;IM;;273;285;558
5517;RAPAGNANO;FM;;946;981;1927
5518;RAPALLO;GE;;13838;15269;29107
5519;RAPINO;CH;;600;602;1202
5520;RAPOLANO TERME;SI;;2463;2567;5030
5521;RAPOLLA;PZ;;2120;2071;4191
5522;RAPONE;PZ;;419;466;885
5523;RASSA;VC;;35;27;62
5524;RASUN ANTERSELVA/RASEN-ANTHOLZ;BZ;;1455;1456;2911
5525;RASURA;SO;;151;140;291
5526;RAVANUSA;AG;;5093;5407;10500
5527;RAVARINO;MO;;3067;3147;6214
5528;RAVASCLETTO;UD;;251;243;494
5529;RAVELLO;SA;;1173;1222;2395
5530;RAVENNA;RA;;75796;80040;155836
5531;RAVEO;UD;;216;228;444
5532;RAVISCANINA;CE;;573;611;1184
5533;RE;VB;;346;352;698
5534;REA;PV;;177;212;389
5535;REALMONTE;AG;;2161;2223;4384
5536;REANA DEL ROJALE;UD;;2313;2424;4737
5537;REANO;TO;;866;887;1753
5538;RECALE;CE;;3814;3833;7647
5539;RECANATI;MC;;10010;10687;20697
5540;RECCO;GE;;4448;5016;9464
5541;RECETTO;NO;;504;452;956
5542;RECOARO TERME;VI;;3018;3058;6076
5543;REDAVALLE;PV;;547;517;1064
5544;REDONDESCO;MN;;607;607;1214
5545;REFRANCORE;AT;;779;800;1579
5546;REFRONTOLO;TV;;854;874;1728
5547;REGALBUTO;EN;;3336;3407;6743
5548;REGGELLO;FI;;8168;8361;16529
5549;REGGIO DI CALABRIA;RC;;82576;89903;172479
5550;REGGIO NELL'EMILIA;RE;;83739;86169;169908
5551;REGGIOLO;RE;;4592;4531;9123
5552;REINO;BN;;547;565;1112
5553;REITANO;ME;;373;360;733
5554;REMANZACCO;UD;;2935;3129;6064
5555;REMEDELLO;BS;;1682;1664;3346
5556;RENATE;MB;;1998;1993;3991
5557;RENDE;CS;;17780;18343;36123
5558;RENON/RITTEN;BZ;;4043;4019;8062
5559;RESANA;TV;;4714;4666;9380
5560;RESCALDINA;MI;;6966;7163;14129
5561;RESIA;UD;;478;455;933
5562;RESIUTTA;UD;;130;129;259
5563;RESUTTANO;CL;;863;904;1767
5564;RETORBIDO;PV;;718;812;1530
5565;REVELLO;CN;;2132;2061;4193
5566;REVIGLIASCO D'ASTI;AT;;362;367;729
5567;REVINE LAGO;TV;;1060;1043;2103
5568;REZZAGO;CO;;163;145;308
5569;REZZATO;BS;;6610;6735;13345
5570;REZZO;IM;;156;156;312
5571;REZZOAGLIO;GE;;428;447;875
5572;RHEMES-NOTRE-DAME;AO;;44;37;81
5573;RHEMES-SAINT-GEORGES;AO;;87;80;167
5574;RHO;MI;;24454;26164;50618
5575;RIACE;RC;;900;913;1813
5576;RIALTO;SV;;278;268;546
5577;RIANO;RM;;5145;5126;10271
5578;RIARDO;CE;;1104;1141;2245
5579;RIBERA;AG;;8676;9310;17986
5580;RIBORDONE;TO;;27;22;49
5581;RICADI;VV;;2506;2453;4959
5582;RICALDONE;AL;;320;292;612
5583;RICCIA;CB;;2416;2485;4901
5584;RICCIONE;RN;;16320;18283;34603
5585;RICCO' DEL GOLFO DI SPEZIA;SP;;1789;1826;3615
5586;RICENGO;CR;;882;856;1738
5587;RICIGLIANO;SA;;521;552;1073
5588;RIESE PIO X;TV;;5485;5416;10901
5589;RIESI;CL;;5055;5576;10631
5590;RIETI;RI;;22012;23545;45557
5591;RIFIANO/RIFFIAN;BZ;;696;674;1370
5592;RIFREDDO;CN;;524;526;1050
5593;RIGNANO FLAMINIO;RM;;4948;5157;10105
5594;RIGNANO GARGANICO;FG;;894;953;1847
5595;RIGNANO SULL'ARNO;FI;;4267;4299;8566
5596;RIGOLATO;UD;;194;175;369
5597;RIMELLA;VC;;79;54;133
5598;RIMINI;RN;;71866;77303;149169
5599;RIO;LI;;1660;1655;3315
5600;RIO DI PUSTERIA/MUHLBACH;BZ;;1584;1558;3142
5601;RIO SALICETO;RE;;3004;2998;6002
5602;RIOFREDDO;RM;;365;374;739
5603;RIOLA SARDO;OR;;1067;993;2060
5604;RIOLO TERME;RA;;2889;2878;5767
5605;RIOLUNATO;MO;;343;319;662
5606;RIOMAGGIORE;SP;;676;677;1353
5607;RIONERO IN VULTURE;PZ;;6273;6363;12636
5608;RIONERO SANNITICO;IS;;516;482;998
5609;RIPA TEATINA;CH;;2016;1965;3981
5610;RIPABOTTONI;CB;;226;230;456
5611;RIPACANDIDA;PZ;;812;782;1594
5612;RIPALIMOSANI;CB;;1554;1482;3036
5613;RIPALTA ARPINA;CR;;518;483;1001
5614;RIPALTA CREMASCA;CR;;1716;1698;3414
5615;RIPALTA GUERINA;CR;;285;247;532
5616;RIPARBELLA;PI;;789;783;1572
5617;RIPATRANSONE;AP;;2008;2034;4042
5618;RIPE SAN GINESIO;MC;;399;419;818
5619;RIPI;FR;;2509;2550;5059
5620;RIPOSTO;CT;;6884;7194;14078
5621;RITTANA;CN;;52;57;109
5622;RIVA DEL GARDA;TN;;8519;9223;17742
5623;RIVA DEL PO;FE;;3687;3824;7511
5624;RIVA DI SOLTO;BG;;436;445;881
5625;RIVA LIGURE;IM;;1411;1401;2812
5626;RIVA PRESSO CHIERI;TO;;2349;2401;4750
5627;RIVALBA;TO;;575;583;1158
5628;RIVALTA BORMIDA;AL;;688;706;1394
5629;RIVALTA DI TORINO;TO;;9951;10221;20172
5630;RIVAMONTE AGORDINO;BL;;331;296;627
5631;RIVANAZZANO TERME;PV;;2454;2685;5139
5632;RIVARA;TO;;1236;1260;2496
5633;RIVAROLO CANAVESE;TO;;5916;6364;12280
5634;RIVAROLO DEL RE ED UNITI;CR;;925;899;1824
5635;RIVAROLO MANTOVANO;MN;;1189;1226;2415
5636;RIVARONE;AL;;229;164;393
5637;RIVAROSSA;TO;;775;773;1548
5638;RIVE;VC;;207;217;424
5639;RIVE D'ARCANO;UD;;1138;1220;2358
5640;RIVELLO;PZ;;1216;1326;2542
5641;RIVERGARO;PC;;3454;3569;7023
5642;RIVIGNANO TEOR;UD;;3107;3078;6185
5643;RIVISONDOLI;AQ;;367;307;674
5644;RIVODUTRI;RI;;591;559;1150
5645;RIVOLI;TO;;22771;24710;47481
5646;RIVOLI VERONESE;VR;;1099;1076;2175
5647;RIVOLTA D'ADDA;CR;;4018;4119;8137
5648;RIZZICONI;RC;;3939;3772;7711
5649;ROANA;VI;;2117;2044;4161
5650;ROASCHIA;CN;;49;46;95
5651;ROASCIO;CN;;45;46;91
5652;ROASIO;VC;;1090;1160;2250
5653;ROATTO;AT;;185;183;368
5654;ROBASSOMERO;TO;;1489;1563;3052
5655;ROBBIATE;LC;;3104;3158;6262
5656;ROBBIO;PV;;2775;2992;5767
5657;ROBECCHETTO CON INDUNO;MI;;2377;2390;4767
5658;ROBECCO D'OGLIO;CR;;1078;1171;2249
5659;ROBECCO PAVESE;PV;;259;259;518
5660;ROBECCO SUL NAVIGLIO;MI;;3309;3436;6745
5661;ROBELLA;AT;;234;203;437
5662;ROBILANTE;CN;;1061;1086;2147
5663;ROBURENT;CN;;239;237;476
5664;ROCCA CANAVESE;TO;;831;836;1667
5665;ROCCA CANTERANO;RM;;97;85;182
5666;ROCCA CIGLIE';CN;;58;67;125
5667;ROCCA D'ARAZZO;AT;;464;445;909
5668;ROCCA D'ARCE;FR;;453;458;911
5669;ROCCA D'EVANDRO;CE;;1504;1538;3042
5670;ROCCA DE' BALDI;CN;;778;787;1565
5671;ROCCA DE' GIORGI;PV;;31;29;60
5672;ROCCA DI BOTTE;AQ;;459;397;856
5673;ROCCA DI CAMBIO;AQ;;257;233;490
5674;ROCCA DI CAVE;RM;;178;171;349
5675;ROCCA DI MEZZO;AQ;;688;660;1348
5676;ROCCA DI NETO;KR;;2675;2668;5343
5677;ROCCA DI PAPA;RM;;8897;8493;17390
5678;ROCCA GRIMALDA;AL;;742;688;1430
5679;ROCCA IMPERIALE;CS;;1603;1623;3226
5680;ROCCA MASSIMA;LT;;562;518;1080
5681;ROCCA PIA;AQ;;96;82;178
5682;ROCCA PIETORE;BL;;559;587;1146
5683;ROCCA PRIORA;RM;;6042;6034;12076
5684;ROCCA SAN CASCIANO;FC;;888;903;1791
5685;ROCCA SAN FELICE;AV;;402;395;797
5686;ROCCA SAN GIOVANNI;CH;;1145;1136;2281
5687;ROCCA SANTA MARIA;TE;;258;219;477
5688;ROCCA SANTO STEFANO;RM;;482;452;934
5689;ROCCA SINIBALDA;RI;;420;370;790
5690;ROCCA SUSELLA;PV;;114;114;228
5691;ROCCABASCERANA;AV;;1167;1152;2319
5692;ROCCABERNARDA;KR;;1557;1610;3167
5693;ROCCABIANCA;PR;;1432;1455;2887
5694;ROCCABRUNA;CN;;750;781;1531
5695;ROCCACASALE;AQ;;301;297;598
5696;ROCCADASPIDE;SA;;3413;3558;6971
5697;ROCCAFIORITA;ME;;82;100;182
5698;ROCCAFLUVIONE;AP;;967;936;1903
5699;ROCCAFORTE DEL GRECO;RC;;184;183;367
5700;ROCCAFORTE LIGURE;AL;;74;49;123
5701;ROCCAFORTE MONDOVI';CN;;1063;993;2056
5702;ROCCAFORZATA;TA;;886;914;1800
5703;ROCCAFRANCA;BS;;2444;2391;4835
5704;ROCCAGIOVINE;RM;;128;131;259
5705;ROCCAGLORIOSA;SA;;778;785;1563
5706;ROCCAGORGA;LT;;2087;2115;4202
5707;ROCCALBEGNA;GR;;470;453;923
5708;ROCCALUMERA;ME;;1914;2000;3914
5709;ROCCAMANDOLFI;IS;;431;426;857
5710;ROCCAMENA;PA;;672;722;1394
5711;ROCCAMONFINA;CE;;1562;1644;3206
5712;ROCCAMONTEPIANO;CH;;775;797;1572
5713;ROCCAMORICE;PE;;418;476;894
5714;ROCCANOVA;PZ;;640;673;1313
5715;ROCCANTICA;RI;;268;280;548
5716;ROCCAPALUMBA;PA;;1094;1170;2264
5717;ROCCAPIEMONTE;SA;;4292;4426;8718
5718;ROCCARAINOLA;NA;;3218;3405;6623
5719;ROCCARASO;AQ;;752;755;1507
5720;ROCCAROMANA;CE;;389;450;839
5721;ROCCASCALEGNA;CH;;538;519;1057
5722;ROCCASECCA;FR;;3498;3477;6975
5723;ROCCASECCA DEI VOLSCI;LT;;524;526;1050
5724;ROCCASICURA;IS;;247;245;492
5725;ROCCASPARVERA;CN;;377;366;743
5726;ROCCASPINALVETI;CH;;575;620;1195
5727;ROCCASTRADA;GR;;4304;4457;8761
5728;ROCCAVALDINA;ME;;485;521;1006
5729;ROCCAVERANO;AT;;200;168;368
5730;ROCCAVIGNALE;SV;;373;368;741
5731;ROCCAVIONE;CN;;1306;1330;2636
5732;ROCCAVIVARA;CB;;302;339;641
5733;ROCCELLA IONICA;RC;;2944;3236;6180
5734;ROCCELLA VALDEMONE;ME;;285;282;567
5735;ROCCHETTA A VOLTURNO;IS;;543;531;1074
5736;ROCCHETTA BELBO;CN;;82;73;155
5737;ROCCHETTA DI VARA;SP;;351;323;674
5738;ROCCHETTA E CROCE;CE;;232;219;451
5739;ROCCHETTA LIGURE;AL;;120;98;218
5740;ROCCHETTA NERVINA;IM;;155;138;293
5741;ROCCHETTA PALAFEA;AT;;175;167;342
5742;ROCCHETTA SANT'ANTONIO;FG;;827;856;1683
5743;ROCCHETTA TANARO;AT;;675;692;1367
5744;RODANO;MI;;2294;2333;4627
5745;RODDI;CN;;788;784;1572
5746;RODDINO;CN;;223;186;409
5747;RODELLO;CN;;477;486;963
5748;RODENGO SAIANO;BS;;4782;5015;9797
5749;RODENGO/RODENECK;BZ;;646;607;1253
5750;RODERO;CO;;630;629;1259
5751;RODI GARGANICO;FG;;1667;1683;3350
5752;RODI' MILICI;ME;;957;990;1947
5753;RODIGO;MN;;2554;2599;5153
5754;ROE' VOLCIANO;BS;;2107;2259;4366
5755;ROFRANO;SA;;667;626;1293
5756;ROGENO;LC;;1558;1500;3058
5757;ROGGIANO GRAVINA;CS;;3304;3516;6820
5758;ROGHUDI;RC;;478;493;971
5759;ROGLIANO;CS;;2734;2665;5399
5760;ROGNANO;PV;;330;330;660
5761;ROGNO;BG;;1925;1949;3874
5762;ROGOLO;SO;;285;276;561
5763;ROIATE;RM;;314;335;649
5764;ROIO DEL SANGRO;CH;;49;49;98
5765;ROISAN;AO;;506;499;1005
5766;ROLETTO;TO;;1008;980;1988
5767;ROLO;RE;;2041;1975;4016
5768;ROMA;RM;;1305497;1443534;2749031
5769;ROMAGNANO AL MONTE;SA;;171;204;375
5770;ROMAGNANO SESIA;NO;;1761;1916;3677
5771;ROMAGNESE;PV;;308;272;580
5772;ROMANA;SS;;236;261;497
5773;ROMANENGO;CR;;1574;1616;3190
5774;ROMANO CANAVESE;TO;;1291;1351;2642
5775;ROMANO D'EZZELINO;VI;;7013;7137;14150
5776;ROMANO DI LOMBARDIA;BG;;10429;10184;20613
5777;ROMANS D'ISONZO;GO;;1781;1855;3636
5778;ROMBIOLO;VV;;2202;2152;4354
5779;ROMENO;TN;;722;675;1397
5780;ROMENTINO;NO;;2753;2872;5625
5781;ROMETTA;ME;;3211;3318;6529
5782;RONCA';VR;;1900;1852;3752
5783;RONCADE;TV;;7310;7370;14680
5784;RONCADELLE;BS;;4617;4665;9282
5785;RONCARO;PV;;791;764;1555
5786;RONCEGNO TERME;TN;;1434;1480;2914
5787;RONCELLO;MB;;2387;2398;4785
5788;RONCHI DEI LEGIONARI;GO;;5809;5998;11807
5789;RONCHI VALSUGANA;TN;;240;214;454
5790;RONCHIS;UD;;961;981;1942
5791;RONCIGLIONE;VT;;4200;4217;8417
5792;RONCO ALL'ADIGE;VR;;3021;2925;5946
5793;RONCO BIELLESE;BI;;729;703;1432
5794;RONCO BRIANTINO;MB;;1783;1798;3581
5795;RONCO CANAVESE;TO;;157;136;293
5796;RONCO SCRIVIA;GE;;2088;2091;4179
5797;RONCOBELLO;BG;;216;204;420
5798;RONCOFERRARO;MN;;3346;3456;6802
5799;RONCOFREDDO;FC;;1725;1654;3379
5800;RONCOLA;BG;;448;421;869
5801;RONDANINA;GE;;36;24;60
5802;RONDISSONE;TO;;951;898;1849
5803;RONSECCO;VC;;250;293;543
5804;RONZO-CHIENIS;TN;;525;467;992
5805;RONZONE;TN;;234;225;459
5806;ROPPOLO;BI;;412;449;861
5807;RORA';TO;;122;105;227
5808;ROSA';VI;;7256;7393;14649
5809;ROSARNO;RC;;7334;7305;14639
5810;ROSASCO;PV;;269;277;546
5811;ROSATE;MI;;2900;2858;5758
5812;ROSAZZA;BI;;48;56;104
5813;ROSCIANO;PE;;1965;2073;4038
5814;ROSCIGNO;SA;;336;326;662
5815;ROSE;CS;;2061;2103;4164
5816;ROSELLO;CH;;90;96;186
5817;ROSETO CAPO SPULICO;CS;;929;930;1859
5818;ROSETO DEGLI ABRUZZI;TE;;12403;13070;25473
5819;ROSETO VALFORTORE;FG;;478;508;986
5820;ROSIGNANO MARITTIMO;LI;;14524;15548;30072
5821;ROSIGNANO MONFERRATO;AL;;702;756;1458
5822;ROSOLINA;RO;;3122;3099;6221
5823;ROSOLINI;SR;;10202;10437;20639
5824;ROSORA;AN;;911;947;1858
5825;ROSSA;VC;;97;78;175
5826;ROSSANA;CN;;430;390;820
5827;ROSSANO VENETO;VI;;4064;4119;8183
5828;ROSSIGLIONE;GE;;1236;1324;2560
5829;ROSTA;TO;;2469;2587;5056
5830;ROTA D'IMAGNA;BG;;443;452;895
5831;ROTA GRECA;CS;;508;503;1011
5832;ROTELLA;AP;;409;406;815
5833;ROTELLO;CB;;569;553;1122
5834;ROTONDA;PZ;;1631;1594;3225
5835;ROTONDELLA;MT;;1180;1268;2448
5836;ROTONDI;AV;;1725;1699;3424
5837;ROTTOFRENO;PC;;5999;6201;12200
5838;ROTZO;VI;;317;324;641
5839;ROURE;TO;;371;394;765
5840;ROVASENDA;VC;;438;474;912
5841;ROVATO;BS;;9840;9358;19198
5842;ROVEGNO;GE;;274;218;492
5843;ROVELLASCA;CO;;3908;4015;7923
5844;ROVELLO PORRO;CO;;3052;3157;6209
5845;ROVERBELLA;MN;;4327;4343;8670
5846;ROVERCHIARA;VR;;1327;1255;2582
5847;ROVERE' DELLA LUNA;TN;;834;804;1638
5848;ROVERE' VERONESE;VR;;1069;1025;2094
5849;ROVEREDO DI GUA';VR;;815;803;1618
5850;ROVEREDO IN PIANO;PN;;2836;3024;5860
5851;ROVERETO;TN;;19052;20714;39766
5852;ROVESCALA;PV;;418;427;845
5853;ROVETTA;BG;;2016;2094;4110
5854;ROVIANO;RM;;590;666;1256
5855;ROVIGO;RO;;24174;26016;50190
5856;ROVITO;CS;;1526;1499;3025
5857;ROVOLON;PD;;2441;2437;4878
5858;ROZZANO;MI;;20084;21351;41435
5859;RUBANO;PD;;8125;8669;16794
5860;RUBIANA;TO;;1181;1210;2391
5861;RUBIERA;RE;;7270;7495;14765
5862;RUDA;UD;;1357;1433;2790
5863;RUDIANO;BS;;2976;2881;5857
5864;RUEGLIO;TO;;393;395;788
5865;RUFFANO;LE;;4500;4853;9353
5866;RUFFIA;CN;;196;168;364
5867;RUFFRE'-MENDOLA;TN;;224;203;427
5868;RUFINA;FI;;3522;3596;7118
5869;RUINAS;OR;;299;322;621
5870;RUMO;TN;;406;392;798
5871;RUOTI;PZ;;1659;1686;3345
5872;RUSSI;RA;;5977;6130;12107
5873;RUTIGLIANO;BA;;9011;9251;18262
5874;RUTINO;SA;;399;366;765
5875;RUVIANO;CE;;833;883;1716
5876;RUVO DEL MONTE;PZ;;491;510;1001
5877;RUVO DI PUGLIA;BA;;11959;12561;24520
5878;SABAUDIA;LT;;10015;9651;19666
5879;SABBIO CHIESE;BS;;1994;1938;3932
5880;SABBIONETA;MN;;2041;2059;4100
5881;SACCO;SA;;214;229;443
5882;SACCOLONGO;PD;;2438;2462;4900
5883;SACILE;PN;;9673;10204;19877
5884;SACROFANO;RM;;3652;3751;7403
5885;SADALI;SU;;435;438;873
5886;SAGAMA;OR;;98;97;195
5887;SAGLIANO MICCA;BI;;740;800;1540
5888;SAGRADO;GO;;1059;1109;2168
5889;SAGRON MIS;TN;;92;86;178
5890;SAINT-CHRISTOPHE;AO;;1749;1735;3484
5891;SAINT-DENIS;AO;;189;182;371
5892;SAINT-MARCEL;AO;;644;668;1312
5893;SAINT-NICOLAS;AO;;170;151;321
5894;SAINT-OYEN;AO;;89;109;198
5895;SAINT-PIERRE;AO;;1607;1633;3240
5896;SAINT-RHEMY-EN-BOSSES;AO;;177;153;330
5897;SAINT-VINCENT;AO;;2163;2288;4451
5898;SALA BAGANZA;PR;;2962;2840;5802
5899;SALA BIELLESE;BI;;275;296;571
5900;SALA BOLOGNESE;BO;;4211;4251;8462
5901;SALA COMACINA;CO;;243;238;481
5902;SALA CONSILINA;SA;;5951;6307;12258
5903;SALA MONFERRATO;AL;;163;177;340
5904;SALANDRA;MT;;1273;1302;2575
5905;SALAPARUTA;TP;;760;835;1595
5906;SALARA;RO;;501;552;1053
5907;SALASCO;VC;;114;93;207
5908;SALASSA;TO;;879;913;1792
5909;SALBERTRAND;TO;;318;287;605
5910;SALCEDO;VI;;513;511;1024
5911;SALCITO;CB;;327;304;631
5912;SALE;AL;;1910;2006;3916
5913;SALE DELLE LANGHE;CN;;243;229;472
5914;SALE MARASINO;BS;;1614;1676;3290
5915;SALE SAN GIOVANNI;CN;;79;75;154
5916;SALEMI;TP;;5027;5055;10082
5917;SALENTO;SA;;886;916;1802
5918;SALERANO CANAVESE;TO;;227;231;458
5919;SALERANO SUL LAMBRO;LO;;1281;1321;2602
5920;SALERNO;SA;;60218;67918;128136
5921;SALGAREDA;TV;;3312;3255;6567
5922;SALI VERCELLESE;VC;;48;51;99
5923;SALICE SALENTINO;LE;;3777;4061;7838
5924;SALICETO;CN;;575;609;1184
5925;SALISANO;RI;;238;260;498
5926;SALIZZOLE;VR;;1943;1816;3759
5927;SALLE;PE;;136;134;270
5928;SALMOUR;CN;;384;332;716
5929;SALO';BS;;4904;5544;10448
5930;SALORNO SULLA STRADA DEL VINO/SALURN AN DER WEINSTRASSE;BZ;;1893;1875;3768
5931;SALSOMAGGIORE TERME;PR;;9869;10037;19906
5932;SALTRIO;VA;;1441;1546;2987
5933;SALUDECIO;RN;;1545;1503;3048
5934;SALUGGIA;VC;;1840;1937;3777
5935;SALUSSOLA;BI;;959;909;1868
5936;SALUZZO;CN;;8597;8836;17433
5937;SALVE;LE;;2147;2338;4485
5938;SALVIROLA;CR;;578;584;1162
5939;SALVITELLE;SA;;240;256;496
5940;SALZA DI PINEROLO;TO;;48;26;74
5941;SALZA IRPINA;AV;;360;363;723
5942;SALZANO;VE;;6363;6439;12802
5943;SAMARATE;VA;;7931;8106;16037
5944;SAMASSI;SU;;2367;2469;4836
5945;SAMATZAI;SU;;772;786;1558
5946;SAMBUCA DI SICILIA;AG;;2690;2728;5418
5947;SAMBUCA PISTOIESE;PT;;729;717;1446
5948;SAMBUCI;RM;;411;428;839
5949;SAMBUCO;CN;;42;44;86
5950;SAMMICHELE DI BARI;BA;;2941;3133;6074
5951;SAMO;RC;;355;382;737
5952;SAMOLACO;SO;;1408;1478;2886
5953;SAMONE;TN;;286;258;544
5954;SAMONE;TO;;732;736;1468
5955;SAMPEYRE;CN;;499;489;988
5956;SAMUGHEO;OR;;1383;1413;2796
5957;SAN BARTOLOMEO AL MARE;IM;;1386;1557;2943
5958;SAN BARTOLOMEO IN GALDO;BN;;2158;2259;4417
5959;SAN BARTOLOMEO VAL CAVARGNA;CO;;470;497;967
5960;SAN BASILE;CS;;449;505;954
5961;SAN BASILIO;SU;;593;557;1150
5962;SAN BASSANO;CR;;1004;1101;2105
5963;SAN BELLINO;RO;;530;505;1035
5964;SAN BENEDETTO BELBO;CN;;76;75;151
5965;SAN BENEDETTO DEI MARSI;AQ;;1868;1878;3746
5966;SAN BENEDETTO DEL TRONTO;AP;;22250;24750;47000
5967;SAN BENEDETTO IN PERILLIS;AQ;;53;45;98
5968;SAN BENEDETTO PO;MN;;3346;3370;6716
5969;SAN BENEDETTO ULLANO;CS;;690;700;1390
5970;SAN BENEDETTO VAL DI SAMBRO;BO;;2161;2041;4202
5971;SAN BENIGNO CANAVESE;TO;;2960;3039;5999
5972;SAN BERNARDINO VERBANO;VB;;634;622;1256
5973;SAN BIAGIO DELLA CIMA;IM;;603;643;1246
5974;SAN BIAGIO DI CALLALTA;TV;;6392;6369;12761
5975;SAN BIAGIO PLATANI;AG;;1374;1545;2919
5976;SAN BIAGIO SARACINISCO;FR;;150;163;313
5977;SAN BIASE;CB;;65;69;134
5978;SAN BONIFACIO;VR;;10693;10661;21354
5979;SAN BUONO;CH;;456;413;869
5980;SAN CALOGERO;VV;;1976;1966;3942
5981;SAN CANDIDO/INNICHEN;BZ;;1677;1728;3405
5982;SAN CANZIAN D'ISONZO;GO;;2973;3067;6040
5983;SAN CARLO CANAVESE;TO;;1955;2055;4010
5984;SAN CASCIANO DEI BAGNI;SI;;749;767;1516
5985;SAN CASCIANO IN VAL DI PESA;FI;;8020;8623;16643
5986;SAN CASSIANO;LE;;981;982;1963
5987;SAN CATALDO;CL;;10264;10948;21212
5988;SAN CESAREO;RM;;7994;7966;15960
5989;SAN CESARIO DI LECCE;LE;;3782;4130;7912
5990;SAN CESARIO SUL PANARO;MO;;3277;3297;6574
5991;SAN CHIRICO NUOVO;PZ;;603;603;1206
5992;SAN CHIRICO RAPARO;PZ;;490;463;953
5993;SAN CIPIRELLO;PA;;2440;2558;4998
5994;SAN CIPRIANO D'AVERSA;CE;;6566;6564;13130
5995;SAN CIPRIANO PICENTINO;SA;;3190;3326;6516
5996;SAN CIPRIANO PO;PV;;242;223;465
5997;SAN CLEMENTE;RN;;2813;2858;5671
5998;SAN COLOMBANO AL LAMBRO;MI;;3576;3663;7239
5999;SAN COLOMBANO BELMONTE;TO;;176;182;358
6000;SAN COLOMBANO CERTENOLI;GE;;1306;1257;2563
6001;SAN CONO;CT;;1217;1223;2440
6002;SAN COSMO ALBANESE;CS;;272;306;578
6003;SAN COSTANTINO ALBANESE;PZ;;304;320;624
6004;SAN COSTANTINO CALABRO;VV;;1024;1065;2089
6005;SAN COSTANZO;PU;;2290;2264;4554
6006;SAN CRISTOFORO;AL;;260;282;542
6007;SAN DAMIANO AL COLLE;PV;;322;307;629
6008;SAN DAMIANO D'ASTI;AT;;3973;4102;8075
6009;SAN DAMIANO MACRA;CN;;215;199;414
6010;SAN DANIELE DEL FRIULI;UD;;3812;4102;7914
6011;SAN DANIELE PO;CR;;649;642;1291
6012;SAN DEMETRIO CORONE;CS;;1494;1628;3122
6013;SAN DEMETRIO NE' VESTINI;AQ;;935;967;1902
6014;SAN DIDERO;TO;;256;260;516
6015;SAN DONA' DI PIAVE;VE;;20014;21650;41664
6016;SAN DONACI;BR;;3005;3211;6216
6017;SAN DONATO DI LECCE;LE;;2556;2928;5484
6018;SAN DONATO DI NINEA;CS;;538;593;1131
6019;SAN DONATO MILANESE;MI;;15529;16479;32008
6020;SAN DONATO VAL DI COMINO;FR;;916;981;1897
6021;SAN DORLIGO DELLA VALLE-DOLINA;TS;;2832;2861;5693
6022;SAN FELE;PZ;;1298;1357;2655
6023;SAN FELICE A CANCELLO;CE;;8365;8598;16963
6024;SAN FELICE CIRCEO;LT;;5229;4871;10100
6025;SAN FELICE DEL BENACO;BS;;1685;1780;3465
6026;SAN FELICE DEL MOLISE;CB;;281;279;560
6027;SAN FELICE SUL PANARO;MO;;5304;5375;10679
6028;SAN FERDINANDO;RC;;2441;2047;4488
6029;SAN FERDINANDO DI PUGLIA;BT;;6846;6867;13713
6030;SAN FERMO DELLA BATTAGLIA;CO;;3778;4021;7799
6031;SAN FILI;CS;;1272;1259;2531
6032;SAN FILIPPO DEL MELA;ME;;3347;3444;6791
6033;SAN FIOR;TV;;3393;3450;6843
6034;SAN FIORANO;LO;;930;921;1851
6035;SAN FLORIANO DEL COLLIO;GO;;367;375;742
6036;SAN FLORO;CZ;;341;348;689
6037;SAN FRANCESCO AL CAMPO;TO;;2381;2466;4847
6038;SAN FRATELLO;ME;;1645;1678;3323
6039;SAN GAVINO MONREALE;SU;;3972;4188;8160
6040;SAN GEMINI;TR;;2289;2480;4769
6041;SAN GENESIO ATESINO/JENESIEN;BZ;;1551;1497;3048
6042;SAN GENESIO ED UNITI;PV;;1955;2055;4010
6043;SAN GENNARO VESUVIANO;NA;;6239;5792;12031
6044;SAN GERMANO CHISONE;TO;;866;825;1691
6045;SAN GERMANO VERCELLESE;VC;;733;740;1473
6046;SAN GERVASIO BRESCIANO;BS;;1348;1337;2685
6047;SAN GIACOMO DEGLI SCHIAVONI;CB;;676;716;1392
6048;SAN GIACOMO DELLE SEGNATE;MN;;720;742;1462
6049;SAN GIACOMO FILIPPO;SO;;189;180;369
6050;SAN GIACOMO VERCELLESE;VC;;134;143;277
6051;SAN GILLIO;TO;;1557;1660;3217
6052;SAN GIMIGNANO;SI;;3790;3697;7487
6053;SAN GINESIO;MC;;1555;1559;3114
6054;SAN GIORGIO A CREMANO;NA;;20308;22749;43057
6055;SAN GIORGIO A LIRI;FR;;1509;1534;3043
6056;SAN GIORGIO ALBANESE;CS;;652;684;1336
6057;SAN GIORGIO BIGARELLO;MN;;5863;5949;11812
6058;SAN GIORGIO CANAVESE;TO;;1250;1284;2534
6059;SAN GIORGIO DEL SANNIO;BN;;4724;5091;9815
6060;SAN GIORGIO DELLA RICHINVELDA;PN;;2359;2172;4531
6061;SAN GIORGIO DELLE PERTICHE;PD;;5069;5061;10130
6062;SAN GIORGIO DI LOMELLINA;PV;;513;500;1013
6063;SAN GIORGIO DI NOGARO;UD;;3626;3654;7280
6064;SAN GIORGIO DI PIANO;BO;;4493;4670;9163
6065;SAN GIORGIO IN BOSCO;PD;;3223;3166;6389
6066;SAN GIORGIO IONICO;TA;;6935;7420;14355
6067;SAN GIORGIO LA MOLARA;BN;;1426;1395;2821
6068;SAN GIORGIO LUCANO;MT;;548;530;1078
6069;SAN GIORGIO MONFERRATO;AL;;586;615;1201
6070;SAN GIORGIO MORGETO;RC;;1425;1540;2965
6071;SAN GIORGIO PIACENTINO;PC;;2748;2857;5605
6072;SAN GIORGIO SCARAMPI;AT;;53;44;97
6073;SAN GIORGIO SU LEGNANO;MI;;3295;3402;6697
6074;SAN GIORIO DI SUSA;TO;;482;505;987
6075;SAN GIOVANNI A PIRO;SA;;1814;1834;3648
6076;SAN GIOVANNI AL NATISONE;UD;;3095;2957;6052
6077;SAN GIOVANNI BIANCO;BG;;2337;2288;4625
6078;SAN GIOVANNI DEL DOSSO;MN;;622;623;1245
6079;SAN GIOVANNI DI FASSA;TN;;1774;1802;3576
6080;SAN GIOVANNI DI GERACE;RC;;202;217;419
6081;SAN GIOVANNI GEMINI;AG;;3784;3820;7604
6082;SAN GIOVANNI ILARIONE;VR;;2477;2421;4898
6083;SAN GIOVANNI IN CROCE;CR;;917;972;1889
6084;SAN GIOVANNI IN FIORE;CS;;7824;8282;16106
6085;SAN GIOVANNI IN GALDO;CB;;259;278;537
6086;SAN GIOVANNI IN MARIGNANO;RN;;4595;4856;9451
6087;SAN GIOVANNI IN PERSICETO;BO;;13591;14278;27869
6088;SAN GIOVANNI INCARICO;FR;;1519;1575;3094
6089;SAN GIOVANNI LA PUNTA;CT;;11361;12288;23649
6090;SAN GIOVANNI LIPIONI;CH;;68;71;139
6091;SAN GIOVANNI LUPATOTO;VR;;12405;12929;25334
6092;SAN GIOVANNI ROTONDO;FG;;12908;13474;26382
6093;SAN GIOVANNI SUERGIU;SU;;2849;2840;5689
6094;SAN GIOVANNI TEATINO;CH;;6961;7297;14258
6095;SAN GIOVANNI VALDARNO;AR;;7929;8715;16644
6096;SAN GIULIANO DEL SANNIO;CB;;493;465;958
6097;SAN GIULIANO DI PUGLIA;CB;;482;507;989
6098;SAN GIULIANO MILANESE;MI;;19546;19707;39253
6099;SAN GIULIANO TERME;PI;;15018;15818;30836
6100;SAN GIUSEPPE JATO;PA;;4022;4182;8204
6101;SAN GIUSEPPE VESUVIANO;NA;;15519;14526;30045
6102;SAN GIUSTINO;PG;;5361;5595;10956
6103;SAN GIUSTO CANAVESE;TO;;1582;1679;3261
6104;SAN GODENZO;FI;;525;535;1060
6105;SAN GREGORIO D'IPPONA;VV;;1293;1228;2521
6106;SAN GREGORIO DA SASSOLA;RM;;733;724;1457
6107;SAN GREGORIO DI CATANIA;CT;;5501;5986;11487
6108;SAN GREGORIO MAGNO;SA;;1942;2048;3990
6109;SAN GREGORIO MATESE;CE;;440;448;888
6110;SAN GREGORIO NELLE ALPI;BL;;774;778;1552
6111;SAN LAZZARO DI SAVENA;BO;;15599;17007;32606
6112;SAN LEO;RN;;1425;1393;2818
6113;SAN LEONARDO;UD;;535;510;1045
6114;SAN LEONARDO IN PASSIRIA/ST. LEONHARD IN PASSEIER;BZ;;1842;1773;3615
6115;SAN LEUCIO DEL SANNIO;BN;;1451;1498;2949
6116;SAN LORENZELLO;BN;;1070;1055;2125
6117;SAN LORENZO;RC;;1120;1151;2271
6118;SAN LORENZO AL MARE;IM;;597;629;1226
6119;SAN LORENZO BELLIZZI;CS;;274;277;551
6120;SAN LORENZO DEL VALLO;CS;;1564;1534;3098
6121;SAN LORENZO DI SEBATO/ST. LORENZEN;BZ;;1924;1921;3845
6122;SAN LORENZO DORSINO;TN;;785;787;1572
6123;SAN LORENZO IN CAMPO;PU;;1540;1661;3201
6124;SAN LORENZO ISONTINO;GO;;754;752;1506
6125;SAN LORENZO MAGGIORE;BN;;953;965;1918
6126;SAN LORENZO NUOVO;VT;;980;1014;1994
6127;SAN LUCA;RC;;1707;1775;3482
6128;SAN LUCIDO;CS;;2968;3037;6005
6129;SAN LUPO;BN;;365;358;723
6130;SAN MANGO D'AQUINO;CZ;;700;740;1440
6131;SAN MANGO PIEMONTE;SA;;1298;1312;2610
6132;SAN MANGO SUL CALORE;AV;;565;529;1094
6133;SAN MARCELLINO;CE;;7326;7317;14643
6134;SAN MARCELLO;AN;;995;1031;2026
6135;SAN MARCELLO PITEGLIO;PT;;3652;4019;7671
6136;SAN MARCO ARGENTANO;CS;;3452;3490;6942
6137;SAN MARCO D'ALUNZIO;ME;;869;943;1812
6138;SAN MARCO DEI CAVOTI;BN;;1446;1568;3014
6139;SAN MARCO EVANGELISTA;CE;;3190;3266;6456
6140;SAN MARCO IN LAMIS;FG;;6292;6497;12789
6141;SAN MARCO LA CATOLA;FG;;442;448;890
6142;SAN MARTINO AL TAGLIAMENTO;PN;;726;727;1453
6143;SAN MARTINO ALFIERI;AT;;346;314;660
6144;SAN MARTINO BUON ALBERGO;VR;;7976;8045;16021
6145;SAN MARTINO CANAVESE;TO;;396;415;811
6146;SAN MARTINO D'AGRI;PZ;;352;336;688
6147;SAN MARTINO DALL'ARGINE;MN;;785;813;1598
6148;SAN MARTINO DEL LAGO;CR;;198;199;397
6149;SAN MARTINO DI FINITA;CS;;472;496;968
6150;SAN MARTINO DI LUPARI;PD;;6561;6623;13184
6151;SAN MARTINO DI VENEZZE;RO;;1846;1912;3758
6152;SAN MARTINO IN BADIA/ST. MARTIN IN THURN;BZ;;895;866;1761
6153;SAN MARTINO IN PASSIRIA/ST. MARTIN IN PASSEIER;BZ;;1620;1615;3235
6154;SAN MARTINO IN PENSILIS;CB;;2233;2298;4531
6155;SAN MARTINO IN RIO;RE;;4083;4111;8194
6156;SAN MARTINO IN STRADA;LO;;1865;1845;3710
6157;SAN MARTINO SANNITA;BN;;583;575;1158
6158;SAN MARTINO SICCOMARIO;PV;;3109;3217;6326
6159;SAN MARTINO SULLA MARRUCINA;CH;;419;413;832
6160;SAN MARTINO VALLE CAUDINA;AV;;2382;2423;4805
6161;SAN MARZANO DI SAN GIUSEPPE;TA;;4481;4482;8963
6162;SAN MARZANO OLIVETO;AT;;502;487;989
6163;SAN MARZANO SUL SARNO;SA;;5156;5169;10325
6164;SAN MASSIMO;CB;;433;369;802
6165;SAN MAURIZIO CANAVESE;TO;;5053;5175;10228
6166;SAN MAURIZIO D'OPAGLIO;NO;;1432;1562;2994
6167;SAN MAURO CASTELVERDE;PA;;694;690;1384
6168;SAN MAURO CILENTO;SA;;438;425;863
6169;SAN MAURO DI SALINE;VR;;298;282;580
6170;SAN MAURO FORTE;MT;;660;627;1287
6171;SAN MAURO LA BRUCA;SA;;263;279;542
6172;SAN MAURO MARCHESATO;KR;;947;1005;1952
6173;SAN MAURO PASCOLI;FC;;6012;6180;12192
6174;SAN MAURO TORINESE;TO;;9031;9604;18635
6175;SAN MICHELE AL TAGLIAMENTO;VE;;5558;5873;11431
6176;SAN MICHELE ALL'ADIGE;TN;;2016;1994;4010
6177;SAN MICHELE DI GANZARIA;CT;;1432;1490;2922
6178;SAN MICHELE DI SERINO;AV;;1227;1208;2435
6179;SAN MICHELE MONDOVI';CN;;886;924;1810
6180;SAN MICHELE SALENTINO;BR;;3009;3125;6134
6181;SAN MINIATO;PI;;13574;14193;27767
6182;SAN NAZZARO;BN;;431;431;862
6183;SAN NAZZARO SESIA;NO;;384;347;731
6184;SAN NAZZARO VAL CAVARGNA;CO;;146;132;278
6185;SAN NICANDRO GARGANICO;FG;;6701;7285;13986
6186;SAN NICOLA ARCELLA;CS;;984;965;1949
6187;SAN NICOLA BARONIA;AV;;371;386;757
6188;SAN NICOLA DA CRISSA;VV;;628;616;1244
6189;SAN NICOLA DELL'ALTO;KR;;355;366;721
6190;SAN NICOLA LA STRADA;CE;;11034;11198;22232
6191;SAN NICOLA MANFREDI;BN;;1744;1780;3524
6192;SAN NICOLO' D'ARCIDANO;OR;;1253;1273;2526
6193;SAN NICOLO' DI COMELICO;BL;;193;184;377
6194;SAN NICOLO' GERREI;SU;;374;344;718
6195;SAN PANCRAZIO SALENTINO;BR;;4535;4851;9386
6196;SAN PANCRAZIO/ST. PANKRAZ;BZ;;780;737;1517
6197;SAN PAOLO;BS;;2208;2209;4417
6198;SAN PAOLO ALBANESE;PZ;;100;120;220
6199;SAN PAOLO BEL SITO;NA;;1657;1713;3370
6200;SAN PAOLO D'ARGON;BG;;2908;2894;5802
6201;SAN PAOLO DI CIVITATE;FG;;2732;2831;5563
6202;SAN PAOLO DI JESI;AN;;430;455;885
6203;SAN PAOLO SOLBRITO;AT;;577;583;1160
6204;SAN PELLEGRINO TERME;BG;;2272;2432;4704
6205;SAN PIER D'ISONZO;GO;;1017;976;1993
6206;SAN PIER NICETO;ME;;1279;1353;2632
6207;SAN PIERO PATTI;ME;;1253;1359;2612
6208;SAN PIETRO A MAIDA;CZ;;1899;1913;3812
6209;SAN PIETRO AL NATISONE;UD;;1040;1046;2086
6210;SAN PIETRO AL TANAGRO;SA;;819;840;1659
6211;SAN PIETRO APOSTOLO;CZ;;759;802;1561
6212;SAN PIETRO AVELLANA;IS;;208;231;439
6213;SAN PIETRO CLARENZA;CT;;4077;4152;8229
6214;SAN PIETRO DI CADORE;BL;;774;768;1542
6215;SAN PIETRO DI CARIDA';RC;;478;544;1022
6216;SAN PIETRO DI FELETTO;TV;;2470;2671;5141
6217;SAN PIETRO DI MORUBIO;VR;;1589;1465;3054
6218;SAN PIETRO IN AMANTEA;CS;;241;240;481
6219;SAN PIETRO IN CARIANO;VR;;6204;6684;12888
6220;SAN PIETRO IN CASALE;BO;;6311;6350;12661
6221;SAN PIETRO IN CERRO;PC;;389;405;794
6222;SAN PIETRO IN GU;PD;;2113;2144;4257
6223;SAN PIETRO IN GUARANO;CS;;1712;1722;3434
6224;SAN PIETRO IN LAMA;LE;;1592;1798;3390
6225;SAN PIETRO INFINE;CE;;425;434;859
6226;SAN PIETRO MOSEZZO;NO;;989;982;1971
6227;SAN PIETRO MUSSOLINO;VI;;799;745;1544
6228;SAN PIETRO VAL LEMINA;TO;;742;715;1457
6229;SAN PIETRO VERNOTICO;BR;;6300;6856;13156
6230;SAN PIETRO VIMINARIO;PD;;1551;1497;3048
6231;SAN PIO DELLE CAMERE;AQ;;330;336;666
6232;SAN POLO D'ENZA;RE;;3018;3128;6146
6233;SAN POLO DEI CAVALIERI;RM;;1429;1360;2789
6234;SAN POLO DI PIAVE;TV;;2529;2385;4914
6235;SAN POLO MATESE;CB;;248;228;476
6236;SAN PONSO;TO;;127;121;248
6237;SAN POSSIDONIO;MO;;1697;1754;3451
6238;SAN POTITO SANNITICO;CE;;965;996;1961
6239;SAN POTITO ULTRA;AV;;714;763;1477
6240;SAN PRISCO;CE;;5817;6297;12114
6241;SAN PROCOPIO;RC;;245;250;495
6242;SAN PROSPERO;MO;;3045;2975;6020
6243;SAN QUIRICO D'ORCIA;SI;;1276;1334;2610
6244;SAN QUIRINO;PN;;2087;2104;4191
6245;SAN RAFFAELE CIMENA;TO;;1549;1597;3146
6246;SAN ROBERTO;RC;;782;769;1551
6247;SAN ROCCO AL PORTO;LO;;1629;1718;3347
6248;SAN ROMANO IN GARFAGNANA;LU;;658;694;1352
6249;SAN RUFO;SA;;814;823;1637
6250;SAN SALVATORE DI FITALIA;ME;;518;632;1150
6251;SAN SALVATORE MONFERRATO;AL;;2008;2037;4045
6252;SAN SALVATORE TELESINO;BN;;1891;1951;3842
6253;SAN SALVO;CH;;9756;9799;19555
6254;SAN SEBASTIANO AL VESUVIO;NA;;4192;4529;8721
6255;SAN SEBASTIANO CURONE;AL;;247;278;525
6256;SAN SEBASTIANO DA PO;TO;;918;943;1861
6257;SAN SECONDO DI PINEROLO;TO;;1778;1819;3597
6258;SAN SECONDO PARMENSE;PR;;2890;2926;5816
6259;SAN SEVERINO LUCANO;PZ;;689;715;1404
6260;SAN SEVERINO MARCHE;MC;;5799;6186;11985
6261;SAN SEVERO;FG;;24360;25483;49843
6262;SAN SIRO;CO;;844;849;1693
6263;SAN SOSSIO BARONIA;AV;;737;786;1523
6264;SAN SOSTENE;CZ;;726;688;1414
6265;SAN SOSTI;CS;;939;940;1879
6266;SAN SPERATE;SU;;4196;4202;8398
6267;SAN STINO DI LIVENZA;VE;;6290;6430;12720
6268;SAN TAMMARO;CE;;2872;2842;5714
6269;SAN TEODORO;SS;;2514;2478;4992
6270;SAN TEODORO;ME;;595;649;1244
6271;SAN TOMASO AGORDINO;BL;;307;301;608
6272;SAN VALENTINO IN ABRUZZO CITERIORE;PE;;890;968;1858
6273;SAN VALENTINO TORIO;SA;;5409;5435;10844
6274;SAN VENANZO;TR;;1128;1054;2182
6275;SAN VENDEMIANO;TV;;4873;5011;9884
6276;SAN VERO MILIS;OR;;1216;1218;2434
6277;SAN VINCENZO;LI;;3067;3431;6498
6278;SAN VINCENZO LA COSTA;CS;;1001;1021;2022
6279;SAN VINCENZO VALLE ROVETO;AQ;;1031;1084;2115
6280;SAN VITALIANO;NA;;3138;3283;6421
6281;SAN VITO;SU;;1744;1744;3488
6282;SAN VITO AL TAGLIAMENTO;PN;;7383;7714;15097
6283;SAN VITO AL TORRE;UD;;592;610;1202
6284;SAN VITO CHIETINO;CH;;2563;2612;5175
6285;SAN VITO DEI NORMANNI;BR;;8818;9449;18267
6286;SAN VITO DI CADORE;BL;;942;993;1935
6287;SAN VITO DI FAGAGNA;UD;;828;851;1679
6288;SAN VITO DI LEGUZZANO;VI;;1731;1840;3571
6289;SAN VITO LO CAPO;TP;;2399;2421;4820
6290;SAN VITO ROMANO;RM;;1564;1511;3075
6291;SAN VITO SULLO IONIO;CZ;;776;853;1629
6292;SAN VITTORE DEL LAZIO;FR;;1247;1227;2474
6293;SAN VITTORE OLONA;MI;;3991;4268;8259
6294;SAN ZENO DI MONTAGNA;VR;;734;706;1440
6295;SAN ZENO NAVIGLIO;BS;;2329;2375;4704
6296;SAN ZENONE AL LAMBRO;MI;;2280;2209;4489
6297;SAN ZENONE AL PO;PV;;267;273;540
6298;SAN ZENONE DEGLI EZZELINI;TV;;3744;3538;7282
6299;SANARICA;LE;;712;757;1469
6300;SANDIGLIANO;BI;;1224;1346;2570
6301;SANDRIGO;VI;;4065;4156;8221
6302;SANFRE';CN;;1497;1553;3050
6303;SANFRONT;CN;;1136;1153;2289
6304;SANGANO;TO;;1749;1937;3686
6305;SANGIANO;VA;;752;707;1459
6306;SANGINETO;CS;;630;614;1244
6307;SANGUINETTO;VR;;2042;2027;4069
6308;SANLURI;SU;;4009;4161;8170
6309;SANNAZZARO DE' BURGONDI;PV;;2518;2580;5098
6310;SANNICANDRO DI BARI;BA;;4920;4672;9592
6311;SANNICOLA;LE;;2746;2956;5702
6312;SANREMO;IM;;25270;27648;52918
6313;SANSEPOLCRO;AR;;7425;7802;15227
6314;SANT'AGAPITO;IS;;717;694;1411
6315;SANT'AGATA BOLOGNESE;BO;;3675;3660;7335
6316;SANT'AGATA DE' GOTI;BN;;5132;5256;10388
6317;SANT'AGATA DEL BIANCO;RC;;293;298;591
6318;SANT'AGATA DI ESARO;CS;;872;843;1715
6319;SANT'AGATA DI MILITELLO;ME;;5633;6317;11950
6320;SANT'AGATA DI PUGLIA;FG;;905;926;1831
6321;SANT'AGATA FELTRIA;RN;;999;999;1998
6322;SANT'AGATA FOSSILI;AL;;175;192;367
6323;SANT'AGATA LI BATTIATI;CT;;4333;5005;9338
6324;SANT'AGATA SUL SANTERNO;RA;;1404;1465;2869
6325;SANT'AGNELLO;NA;;4225;4504;8729
6326;SANT'ALBANO STURA;CN;;1219;1138;2357
6327;SANT'ALESSIO CON VIALONE;PV;;525;492;1017
6328;SANT'ALESSIO IN ASPROMONTE;RC;;164;167;331
6329;SANT'ALESSIO SICULO;ME;;747;780;1527
6330;SANT'ALFIO;CT;;733;785;1518
6331;SANT'AMBROGIO DI TORINO;TO;;2290;2307;4597
6332;SANT'AMBROGIO DI VALPOLICELLA;VR;;5876;6047;11923
6333;SANT'AMBROGIO SUL GARIGLIANO;FR;;454;425;879
6334;SANT'ANASTASIA;NA;;12908;13552;26460
6335;SANT'ANATOLIA DI NARCO;PG;;280;246;526
6336;SANT'ANDREA APOSTOLO DELLO IONIO;CZ;;891;868;1759
6337;SANT'ANDREA DEL GARIGLIANO;FR;;654;657;1311
6338;SANT'ANDREA DI CONZA;AV;;666;702;1368
6339;SANT'ANDREA FRIUS;SU;;884;833;1717
6340;SANT'ANGELO A CUPOLO;BN;;2037;2080;4117
6341;SANT'ANGELO A FASANELLA;SA;;245;269;514
6342;SANT'ANGELO A SCALA;AV;;387;315;702
6343;SANT'ANGELO ALL'ESCA;AV;;372;375;747
6344;SANT'ANGELO D'ALIFE;CE;;1012;1077;2089
6345;SANT'ANGELO DEI LOMBARDI;AV;;1999;1914;3913
6346;SANT'ANGELO DEL PESCO;IS;;163;162;325
6347;SANT'ANGELO DI BROLO;ME;;1362;1444;2806
6348;SANT'ANGELO DI PIOVE DI SACCO;PD;;3615;3674;7289
6349;SANT'ANGELO IN PONTANO;MC;;584;660;1244
6350;SANT'ANGELO IN VADO;PU;;1947;1960;3907
6351;SANT'ANGELO LE FRATTE;PZ;;658;656;1314
6352;SANT'ANGELO LIMOSANO;CB;;156;161;317
6353;SANT'ANGELO LODIGIANO;LO;;6648;6698;13346
6354;SANT'ANGELO LOMELLINA;PV;;420;397;817
6355;SANT'ANGELO MUXARO;AG;;565;617;1182
6356;SANT'ANGELO ROMANO;RM;;2493;2452;4945
6357;SANT'ANNA ARRESI;SU;;1356;1307;2663
6358;SANT'ANNA D'ALFAEDO;VR;;1336;1204;2540
6359;SANT'ANTIMO;NA;;16006;16570;32576
6360;SANT'ANTIOCO;SU;;5309;5447;10756
6361;SANT'ANTONINO DI SUSA;TO;;1950;2114;4064
6362;SANT'ANTONIO ABATE;NA;;9518;9651;19169
6363;SANT'ANTONIO DI GALLURA;SS;;715;728;1443
6364;SANT'APOLLINARE;FR;;900;942;1842
6365;SANT'ARCANGELO;PZ;;2972;3060;6032
6366;SANT'ARCANGELO TRIMONTE;BN;;246;234;480
6367;SANT'ARPINO;CE;;7449;7461;14910
6368;SANT'ARSENIO;SA;;1284;1401;2685
6369;SANT'EGIDIO ALLA VIBRATA;TE;;4843;4961;9804
6370;SANT'EGIDIO DEL MONTE ALBINO;SA;;4362;4495;8857
6371;SANT'ELENA;PD;;1247;1283;2530
6372;SANT'ELENA SANNITA;IS;;141;129;270
6373;SANT'ELIA A PIANISI;CB;;765;820;1585
6374;SANT'ELIA FIUMERAPIDO;FR;;2846;2886;5732
6375;SANT'ELPIDIO A MARE;FM;;8224;8319;16543
6376;SANT'EUFEMIA A MAIELLA;PE;;139;126;265
6377;SANT'EUFEMIA D'ASPROMONTE;RC;;1830;1910;3740
6378;SANT'EUSANIO DEL SANGRO;CH;;1118;1161;2279
6379;SANT'EUSANIO FORCONESE;AQ;;175;184;359
6380;SANT'ILARIO D'ENZA;RE;;5547;5658;11205
6381;SANT'ILARIO DELLO IONIO;RC;;669;679;1348
6382;SANT'IPPOLITO;PU;;727;732;1459
6383;SANT'OLCESE;GE;;2792;2809;5601
6384;SANT'OMERO;TE;;2465;2647;5112
6385;SANT'OMOBONO TERME;BG;;1942;1920;3862
6386;SANT'ONOFRIO;VV;;1426;1446;2872
6387;SANT'ORESTE;RM;;1755;1749;3504
6388;SANT'ORSOLA TERME;TN;;567;539;1106
6389;SANT'URBANO;PD;;947;956;1903
6390;SANTA BRIGIDA;BG;;261;262;523
6391;SANTA CATERINA ALBANESE;CS;;548;580;1128
6392;SANTA CATERINA D'ESTE;PD;*;1206;1183;2389
6393;SANTA CATERINA DELLO IONIO;CZ;;958;982;1940
6394;SANTA CATERINA VILLARMOSA;CL;;2240;2545;4785
6395;SANTA CESAREA TERME;LE;;1334;1513;2847
6396;SANTA CRISTINA D'ASPROMONTE;RC;;387;387;774
6397;SANTA CRISTINA E BISSONE;PV;;957;916;1873
6398;SANTA CRISTINA GELA;PA;;504;486;990
6399;SANTA CRISTINA VALGARDENA/ST. CHRISTINA IN GRODEN;BZ;;995;1006;2001
6400;SANTA CROCE CAMERINA;RG;;5812;5100;10912
6401;SANTA CROCE DEL SANNIO;BN;;428;430;858
6402;SANTA CROCE DI MAGLIANO;CB;;1947;2065;4012
6403;SANTA CROCE SULL'ARNO;PI;;7369;7239;14608
6404;SANTA DOMENICA TALAO;CS;;582;558;1140
6405;SANTA DOMENICA VITTORIA;ME;;431;442;873
6406;SANTA ELISABETTA;AG;;1053;1119;2172
6407;SANTA FIORA;GR;;1224;1261;2485
6408;SANTA FLAVIA;PA;;5380;5619;10999
6409;SANTA GIULETTA;PV;;762;801;1563
6410;SANTA GIUSTA;OR;;2321;2325;4646
6411;SANTA GIUSTINA;BL;;3222;3412;6634
6412;SANTA GIUSTINA IN COLLE;PD;;3596;3560;7156
6413;SANTA LUCE;PI;;797;840;1637
6414;SANTA LUCIA DEL MELA;ME;;2184;2244;4428
6415;SANTA LUCIA DI PIAVE;TV;;4586;4541;9127
6416;SANTA LUCIA DI SERINO;AV;;692;713;1405
6417;SANTA MARGHERITA DI BELICE;AG;;2959;3138;6097
6418;SANTA MARGHERITA DI STAFFORA;PV;;238;210;448
6419;SANTA MARGHERITA LIGURE;GE;;3981;4594;8575
6420;SANTA MARIA A MONTE;PI;;6567;6740;13307
6421;SANTA MARIA A VICO;CE;;6958;7291;14249
6422;SANTA MARIA CAPUA VETERE;CE;;15187;16747;31934
6423;SANTA MARIA COGHINAS;SS;;671;638;1309
6424;SANTA MARIA DEL CEDRO;CS;;2443;2506;4949
6425;SANTA MARIA DEL MOLISE;IS;;343;321;664
6426;SANTA MARIA DELLA VERSA;PV;;1091;1151;2242
6427;SANTA MARIA DI LICODIA;CT;;3654;3799;7453
6428;SANTA MARIA DI SALA;VE;;8716;8733;17449
6429;SANTA MARIA HOE';LC;;1087;1043;2130
6430;SANTA MARIA IMBARO;CH;;1020;1000;2020
6431;SANTA MARIA LA CARITA';NA;;5824;5865;11689
6432;SANTA MARIA LA FOSSA;CE;;1270;1289;2559
6433;SANTA MARIA LA LONGA;UD;;1139;1174;2313
6434;SANTA MARIA MAGGIORE;VB;;622;668;1290
6435;SANTA MARIA NUOVA;AN;;1964;2016;3980
6436;SANTA MARINA;SA;;1576;1622;3198
6437;SANTA MARINA SALINA;ME;;452;402;854
6438;SANTA MARINELLA;RM;;9012;9519;18531
6439;SANTA NINFA;TP;;2333;2505;4838
6440;SANTA PAOLINA;AV;;573;602;1175
6441;SANTA SEVERINA;KR;;952;977;1929
6442;SANTA SOFIA;FC;;1944;2074;4018
6443;SANTA SOFIA D'EPIRO;CS;;1066;1139;2205
6444;SANTA TERESA DI RIVA;ME;;4444;4893;9337
6445;SANTA TERESA GALLURA;SS;;2525;2481;5006
6446;SANTA VENERINA;CT;;4133;4288;8421
6447;SANTA VITTORIA D'ALBA;CN;;1451;1423;2874
6448;SANTA VITTORIA IN MATENANO;FM;;596;631;1227
6449;SANTADI;SU;;1572;1622;3194
6450;SANTARCANGELO DI ROMAGNA;RN;;10785;11399;22184
6451;SANTE MARIE;AQ;;556;543;1099
6452;SANTENA;TO;;5203;5328;10531
6453;SANTERAMO IN COLLE;BA;;12745;13125;25870
6454;SANTHIA';VC;;3912;4197;8109
6455;SANTI COSMA E DAMIANO;LT;;3389;3465;6854
6456;SANTO STEFANO AL MARE;IM;;1003;1028;2031
6457;SANTO STEFANO BELBO;CN;;1902;1921;3823
6458;SANTO STEFANO D'AVETO;GE;;512;479;991
6459;SANTO STEFANO DEL SOLE;AV;;1014;1062;2076
6460;SANTO STEFANO DI CADORE;BL;;1169;1236;2405
6461;SANTO STEFANO DI CAMASTRA;ME;;2113;2302;4415
6462;SANTO STEFANO DI MAGRA;SP;;4860;4977;9837
6463;SANTO STEFANO DI ROGLIANO;CS;;837;867;1704
6464;SANTO STEFANO DI SESSANIO;AQ;;54;61;115
6465;SANTO STEFANO IN ASPROMONTE;RC;;568;523;1091
6466;SANTO STEFANO LODIGIANO;LO;;927;922;1849
6467;SANTO STEFANO QUISQUINA;AG;;2006;2153;4159
6468;SANTO STEFANO ROERO;CN;;632;693;1325
6469;SANTO STEFANO TICINO;MI;;2428;2504;4932
6470;SANTOMENNA;SA;;209;192;401
6471;SANTOPADRE;FR;;613;602;1215
6472;SANTORSO;VI;;2743;2787;5530
6473;SANTU LUSSURGIU;OR;;1110;1119;2229
6474;SANZA;SA;;1212;1160;2372
6475;SANZENO;TN;;456;463;919
6476;SAONARA;PD;;5194;5282;10476
6477;SAPONARA;ME;;1819;1885;3704
6478;SAPPADA;UD;;645;663;1308
6479;SAPRI;SA;;3045;3356;6401
6480;SARACENA;CS;;1687;1764;3451
6481;SARACINESCO;RM;;95;71;166
6482;SARCEDO;VI;;2660;2677;5337
6483;SARCONI;PZ;;713;693;1406
6484;SARDARA;SU;;1897;1945;3842
6485;SARDIGLIANO;AL;;186;200;386
6486;SAREGO;VI;;3417;3292;6709
6487;SARENTINO/SARNTAL;BZ;;3638;3552;7190
6488;SAREZZANO;AL;;564;560;1124
6489;SAREZZO;BS;;6519;6613;13132
6490;SARMATO;PC;;1494;1456;2950
6491;SARMEDE;TV;;1483;1468;2951
6492;SARNANO;MC;;1489;1580;3069
6493;SARNICO;BG;;3264;3467;6731
6494;SARNO;SA;;15190;15462;30652
6495;SARNONICO;TN;;403;392;795
6496;SARONNO;VA;;18396;20186;38582
6497;SARRE;AO;;2302;2453;4755
6498;SARROCH;CA;;2541;2516;5057
6499;SARSINA;FC;;1648;1655;3303
6500;SARTEANO;SI;;2112;2364;4476
6501;SARTIRANA LOMELLINA;PV;;701;756;1457
6502;SARULE;NU;;763;801;1564
6503;SARZANA;SP;;10438;11172;21610
6504;SASSANO;SA;;2247;2387;4634
6505;SASSARI;SS;;58742;63417;122159
6506;SASSELLO;SV;;909;838;1747
6507;SASSETTA;LI;;230;245;475
6508;SASSINORO;BN;;306;327;633
6509;SASSO DI CASTALDA;PZ;;390;361;751
6510;SASSO MARCONI;BO;;7154;7644;14798
6511;SASSOCORVARO AUDITORE;PU;;2440;2430;4870
6512;SASSOFELTRIO;RN;;653;713;1366
6513;SASSOFERRATO;AN;;3351;3524;6875
6514;SASSUOLO;MO;;19931;20538;40469
6515;SATRIANO;CZ;;1620;1740;3360
6516;SATRIANO DI LUCANIA;PZ;;1124;1125;2249
6517;SAURIS;UD;;190;200;390
6518;SAUZE D'OULX;TO;;552;491;1043
6519;SAUZE DI CESANA;TO;;139;112;251
6520;SAVA;TA;;7458;7965;15423
6521;SAVELLI;KR;;526;519;1045
6522;SAVIANO;NA;;7816;8117;15933
6523;SAVIGLIANO;CN;;10467;10986;21453
6524;SAVIGNANO IRPINO;AV;;521;505;1026
6525;SAVIGNANO SUL PANARO;MO;;4642;4773;9415
6526;SAVIGNANO SUL RUBICONE;FC;;8830;8967;17797
6527;SAVIGNONE;GE;;1507;1531;3038
6528;SAVIORE DELL'ADAMELLO;BS;;386;416;802
6529;SAVOCA;ME;;822;875;1697
6530;SAVOGNA;UD;;183;168;351
6531;SAVOGNA D'ISONZO;GO;;872;822;1694
6532;SAVOIA DI LUCANIA;PZ;;508;512;1020
6533;SAVONA;SV;;27562;30972;58534
6534;SCAFA;PE;;1694;1814;3508
6535;SCAFATI;SA;;23639;24782;48421
6536;SCAGNELLO;CN;;83;91;174
6537;SCALA;SA;;766;738;1504
6538;SCALA COELI;CS;;390;438;828
6539;SCALDASOLE;PV;;425;427;852
6540;SCALEA;CS;;5584;5492;11076
6541;SCALENGHE;TO;;1649;1595;3244
6542;SCALETTA ZANCLEA;ME;;894;977;1871
6543;SCAMPITELLA;AV;;501;548;1049
6544;SCANDALE;KR;;1416;1473;2889
6545;SCANDIANO;RE;;12520;13247;25767
6546;SCANDICCI;FI;;23748;25911;49659
6547;SCANDOLARA RAVARA;CR;;648;649;1297
6548;SCANDOLARA RIPA D'OGLIO;CR;;277;255;532
6549;SCANDRIGLIA;RI;;1728;1504;3232
6550;SCANNO;AQ;;839;884;1723
6551;SCANO DI MONTIFERRO;OR;;694;723;1417
6552;SCANSANO;GR;;2204;2059;4263
6553;SCANZANO JONICO;MT;;3769;3756;7525
6554;SCANZOROSCIATE;BG;;4843;5038;9881
6555;SCAPOLI;IS;;291;300;591
6556;SCARLINO;GR;;1927;1887;3814
6557;SCARMAGNO;TO;;385;417;802
6558;SCARNAFIGI;CN;;1105;1044;2149
6559;SCARPERIA E SAN PIERO;FI;;5929;6089;12018
6560;SCENA/SCHENNA;BZ;;1495;1485;2980
6561;SCERNI;CH;;1479;1541;3020
6562;SCHEGGIA E PASCELUPO;PG;;641;639;1280
6563;SCHEGGINO;PG;;221;230;451
6564;SCHIAVI DI ABRUZZO;CH;;320;359;679
6565;SCHIAVON;VI;;1332;1271;2603
6566;SCHIGNANO;CO;;467;417;884
6567;SCHILPARIO;BG;;562;578;1140
6568;SCHIO;VI;;18893;19640;38533
6569;SCHIVENOGLIA;MN;;547;543;1090
6570;SCIACCA;AG;;19092;20171;39263
6571;SCIARA;PA;;1274;1295;2569
6572;SCICLI;RG;;13221;13657;26878
6573;SCIDO;RC;;405;436;841
6574;SCIGLIANO;CS;;537;579;1116
6575;SCILLA;RC;;2222;2354;4576
6576;SCILLATO;PA;;286;328;614
6577;SCIOLZE;TO;;732;731;1463
6578;SCISCIANO;NA;;3019;3131;6150
6579;SCLAFANI BAGNI;PA;;182;205;387
6580;SCONTRONE;AQ;;308;247;555
6581;SCOPA;VC;;186;187;373
6582;SCOPELLO;VC;;195;177;372
6583;SCOPPITO;AQ;;1887;1875;3762
6584;SCORDIA;CT;;8106;8105;16211
6585;SCORRANO;LE;;3281;3445;6726
6586;SCORZE';VE;;9483;9482;18965
6587;SCURCOLA MARSICANA;AQ;;1340;1358;2698
6588;SCURELLE;TN;;667;667;1334
6589;SCURZOLENGO;AT;;258;258;516
6590;SEBORGA;IM;;137;144;281
6591;SECINARO;AQ;;170;151;321
6592;SECLI';LE;;873;947;1820
6593;SECUGNAGO;LO;;960;985;1945
6594;SEDEGLIANO;UD;;1854;1850;3704
6595;SEDICO;BL;;4984;5177;10161
6596;SEDILO;OR;;994;1001;1995
6597;SEDINI;SS;;592;664;1256
6598;SEDRIANO;MI;;6266;6285;12551
6599;SEDRINA;BG;;1263;1175;2438
6600;SEFRO;MC;;213;205;418
6601;SEGARIU;SU;;553;559;1112
6602;SEGGIANO;GR;;498;485;983
6603;SEGNI;RM;;4425;4558;8983
6604;SEGONZANO;TN;;683;705;1388
6605;SEGRATE;MI;;17676;18915;36591
6606;SEGUSINO;TV;;919;904;1823
6607;SELARGIUS;CA;;13818;14830;28648
6608;SELCI;RI;;557;555;1112
6609;SELEGAS;SU;;642;664;1306
6610;SELLA GIUDICARIE;TN;;1452;1440;2892
6611;SELLANO;PG;;499;503;1002
6612;SELLERO;BS;;702;698;1400
6613;SELLIA;CZ;;230;264;494
6614;SELLIA MARINA;CZ;;3839;3740;7579
6615;SELVA DEI MOLINI/MUHLWALD;BZ;;733;666;1399
6616;SELVA DI CADORE;BL;;243;250;493
6617;SELVA DI PROGNO;VR;;465;419;884
6618;SELVA DI VAL GARDENA/WOLKENSTEIN IN GRODEN;BZ;;1284;1308;2592
6619;SELVAZZANO DENTRO;PD;;11100;11861;22961
6620;SELVINO;BG;;1021;979;2000
6621;SEMESTENE;SS;;68;73;141
6622;SEMIANA;PV;;102;95;197
6623;SEMINARA;RC;;1220;1268;2488
6624;SEMPRONIANO;GR;;469;515;984
6625;SENAGO;MI;;10526;10834;21360
6626;SENALE-SAN FELICE/UNSERE LIEBE FRAU IM WALDE-ST. FELIX;BZ;;402;379;781
6627;SENALES/SCHNALS;BZ;;648;613;1261
6628;SENEGHE;OR;;840;842;1682
6629;SENERCHIA;AV;;406;345;751
6630;SENIGA;BS;;724;703;1427
6631;SENIGALLIA;AN;;21249;22996;44245
6632;SENIS;OR;;195;229;424
6633;SENISE;PZ;;3318;3317;6635
6634;SENNA COMASCO;CO;;1601;1560;3161
6635;SENNA LODIGIANA;LO;;873;891;1764
6636;SENNARIOLO;OR;;72;83;155
6637;SENNORI;SS;;3451;3484;6935
6638;SENORBI';SU;;2369;2393;4762
6639;SEPINO;CB;;943;852;1795
6640;SEQUALS;PN;;1082;1088;2170
6641;SERAVEZZA;LU;;5942;6499;12441
6642;SERDIANA;SU;;1341;1324;2665
6643;SEREGNO;MB;;21662;23163;44825
6644;SEREN DEL GRAPPA;BL;;1208;1167;2375
6645;SERGNANO;CR;;1767;1738;3505
6646;SERIATE;BG;;12377;12792;25169
6647;SERINA;BG;;1062;989;2051
6648;SERINO;AV;;3389;3380;6769
6649;SERLE;BS;;1513;1547;3060
6650;SERMIDE E FELONICA;MN;;3576;3536;7112
6651;SERMONETA;LT;;5053;4991;10044
6652;SERNAGLIA DELLA BATTAGLIA;TV;;3039;3047;6086
6653;SERNIO;SO;;241;234;475
6654;SEROLE;AT;;50;52;102
6655;SERRA D'AIELLO;CS;;258;256;514
6656;SERRA DE' CONTI;AN;;1764;1794;3558
6657;SERRA RICCO';GE;;3776;3839;7615
6658;SERRA SAN BRUNO;VV;;3198;3157;6355
6659;SERRA SAN QUIRICO;AN;;1208;1344;2552
6660;SERRA SANT'ABBONDIO;PU;;461;458;919
6661;SERRACAPRIOLA;FG;;1818;1886;3704
6662;SERRADIFALCO;CL;;2652;2936;5588
6663;SERRALUNGA D'ALBA;CN;;286;268;554
6664;SERRALUNGA DI CREA;AL;;259;250;509
6665;SERRAMANNA;SU;;4275;4365;8640
6666;SERRAMAZZONI;MO;;4343;4173;8516
6667;SERRAMEZZANA;SA;;140;150;290
6668;SERRAMONACESCA;PE;;280;251;531
6669;SERRAPETRONA;MC;;434;462;896
6670;SERRARA FONTANA;NA;;1511;1533;3044
6671;SERRASTRETTA;CZ;;1471;1474;2945
6672;SERRATA;RC;;395;401;796
6673;SERRAVALLE A PO;MN;;705;736;1441
6674;SERRAVALLE DI CHIENTI;MC;;549;506;1055
6675;SERRAVALLE LANGHE;CN;;157;143;300
6676;SERRAVALLE PISTOIESE;PT;;5767;5975;11742
6677;SERRAVALLE SCRIVIA;AL;;2922;2956;5878
6678;SERRAVALLE SESIA;VC;;2304;2447;4751
6679;SERRE;SA;;1869;1832;3701
6680;SERRENTI;SU;;2328;2253;4581
6681;SERRI;SU;;311;318;629
6682;SERRONE;FR;;1534;1482;3016
6683;SERSALE;CZ;;2092;2199;4291
6684;SERVIGLIANO;FM;;1083;1096;2179
6685;SESSA AURUNCA;CE;;9955;10411;20366
6686;SESSA CILENTO;SA;;576;624;1200
6687;SESSAME;AT;;116;123;239
6688;SESSANO DEL MOLISE;IS;;310;353;663
6689;SESTA GODANO;SP;;652;621;1273
6690;SESTINO;AR;;605;613;1218
6691;SESTO AL REGHENA;PN;;3154;3147;6301
6692;SESTO CALENDE;VA;;5280;5689;10969
6693;SESTO CAMPANO;IS;;1031;1109;2140
6694;SESTO ED UNITI;CR;;1577;1608;3185
6695;SESTO FIORENTINO;FI;;23216;25566;48782
6696;SESTO SAN GIOVANNI;MI;;38270;41172;79442
6697;SESTO/SEXTEN;BZ;;914;932;1846
6698;SESTOLA;MO;;1212;1231;2443
6699;SESTRI LEVANTE;GE;;8372;9235;17607
6700;SESTRIERE;TO;;478;441;919
6701;SESTU;CA;;10476;10324;20800
6702;SETTALA;MI;;3642;3625;7267
6703;SETTEFRATI;FR;;350;359;709
6704;SETTEVILLE;BL;*;2904;2877;5781
6705;SETTIME;AT;;278;281;559
6706;SETTIMO MILANESE;MI;;9731;10331;20062
6707;SETTIMO ROTTARO;TO;;225;248;473
6708;SETTIMO SAN PIETRO;CA;;3407;3475;6882
6709;SETTIMO TORINESE;TO;;22342;23714;46056
6710;SETTIMO VITTONE;TO;;768;723;1491
6711;SETTINGIANO;CZ;;1625;1579;3204
6712;SETZU;SU;;69;64;133
6713;SEUI;SU;;596;582;1178
6714;SEULO;SU;;410;385;795
6715;SEVESO;MB;;11715;12089;23804
6716;SEZZADIO;AL;;565;609;1174
6717;SEZZE;LT;;11948;11778;23726
6718;SFRUZ;TN;;186;184;370
6719;SGONICO;TS;;998;1001;1999
6720;SGURGOLA;FR;;1150;1239;2389
6721;SIAMAGGIORE;OR;;448;436;884
6722;SIAMANNA;OR;;394;379;773
6723;SIANO;SA;;4663;4833;9496
6724;SIAPICCIA;OR;;172;172;344
6725;SICIGNANO DEGLI ALBURNI;SA;;1528;1573;3101
6726;SICULIANA;AG;;2065;2111;4176
6727;SIDDI;SU;;302;293;595
6728;SIDERNO;RC;;8642;8968;17610
6729;SIENA;SI;;24748;28314;53062
6730;SIGILLO;PG;;1118;1187;2305
6731;SIGNA;FI;;9288;9676;18964
6732;SILANDRO/SCHLANDERS;BZ;;3124;3166;6290
6733;SILANUS;NU;;991;1027;2018
6734;SILEA;TV;;4955;5264;10219
6735;SILIGO;SS;;402;410;812
6736;SILIQUA;SU;;1795;1819;3614
6737;SILIUS;SU;;566;498;1064
6738;SILLANO GIUNCUGNANO;LU;;490;509;999
6739;SILLAVENGO;NO;;286;270;556
6740;SILVANO D'ORBA;AL;;961;953;1914
6741;SILVANO PIETRA;PV;;316;316;632
6742;SILVI;TE;;7533;7855;15388
6743;SIMALA;OR;;148;136;284
6744;SIMAXIS;OR;;1081;1065;2146
6745;SIMBARIO;VV;;458;465;923
6746;SIMERI CRICHI;CZ;;2332;2416;4748
6747;SINAGRA;ME;;1231;1267;2498
6748;SINALUNGA;SI;;5921;6207;12128
6749;SINDIA;NU;;773;836;1609
6750;SINI;OR;;253;232;485
6751;SINIO;CN;;244;234;478
6752;SINISCOLA;NU;;5667;5578;11245
6753;SINNAI;CA;;8617;8706;17323
6754;SINOPOLI;RC;;947;944;1891
6755;SIRACUSA;SR;;57349;59706;117055
6756;SIRIGNANO;AV;;1386;1445;2831
6757;SIRIS;OR;;120;103;223
6758;SIRMIONE;BS;;3954;4303;8257
6759;SIROLO;AN;;1963;2133;4096
6760;SIRONE;LC;;1129;1176;2305
6761;SIRTORI;LC;;1407;1370;2777
6762;SISSA TRECASALI;PR;;3863;3979;7842
6763;SIURGUS DONIGALA;SU;;915;933;1848
6764;SIZIANO;PV;;3205;3246;6451
6765;SIZZANO;NO;;663;697;1360
6766;SLUDERNO/SCHLUDERNS;BZ;;918;916;1834
6767;SMERILLO;FM;;170;166;336
6768;SOAVE;VR;;3525;3631;7156
6769;SOCCHIEVE;UD;;426;434;860
6770;SODDI';OR;;54;66;120
6771;SOGLIANO AL RUBICONE;FC;;1576;1571;3147
6772;SOGLIANO CAVOUR;LE;;1948;1984;3932
6773;SOGLIO;AT;;67;68;135
6774;SOIANO DEL LAGO;BS;;979;970;1949
6775;SOLAGNA;VI;;897;910;1807
6776;SOLARINO;SR;;3744;3834;7578
6777;SOLARO;MI;;6883;7041;13924
6778;SOLAROLO;RA;;2144;2249;4393
6779;SOLAROLO RAINERIO;CR;;450;450;900
6780;SOLARUSSA;OR;;1125;1166;2291
6781;SOLBIATE ARNO;VA;;1944;2077;4021
6782;SOLBIATE CON CAGNO;CO;;2265;2366;4631
6783;SOLBIATE OLONA;VA;;2663;2696;5359
6784;SOLDANO;IM;;507;489;996
6785;SOLEMINIS;SU;;926;928;1854
6786;SOLERO;AL;;772;793;1565
6787;SOLESINO;PD;;3351;3459;6810
6788;SOLETO;LE;;2505;2731;5236
6789;SOLFERINO;MN;;1297;1324;2621
6790;SOLIERA;MO;;7641;7784;15425
6791;SOLIGNANO;PR;;882;819;1701
6792;SOLOFRA;AV;;6019;6144;12163
6793;SOLONGHELLO;AL;;102;93;195
6794;SOLOPACA;BN;;1623;1894;3517
6795;SOLTO COLLINA;BG;;892;887;1779
6796;SOLZA;BG;;1009;976;1985
6797;SOMAGLIA;LO;;1906;1933;3839
6798;SOMANO;CN;;160;150;310
6799;SOMMA LOMBARDO;VA;;8706;9043;17749
6800;SOMMA VESUVIANA;NA;;16631;17304;33935
6801;SOMMACAMPAGNA;VR;;7296;7276;14572
6802;SOMMARIVA DEL BOSCO;CN;;3099;3172;6271
6803;SOMMARIVA PERNO;CN;;1303;1391;2694
6804;SOMMATINO;CL;;3029;3412;6441
6805;SOMMO;PV;;571;574;1145
6806;SONA;VR;;8734;8851;17585
6807;SONCINO;CR;;3717;3790;7507
6808;SONDALO;SO;;1913;2017;3930
6809;SONDRIO;SO;;9967;11225;21192
6810;SONGAVAZZO;BG;;355;341;696
6811;SONICO;BS;;613;598;1211
6812;SONNINO;LT;;3693;3747;7440
6813;SORA;FR;;12276;12783;25059
6814;SORAGA DI FASSA;TN;;360;335;695
6815;SORAGNA;PR;;2403;2375;4778
6816;SORANO;GR;;1523;1574;3097
6817;SORBO SAN BASILE;CZ;;372;401;773
6818;SORBO SERPICO;AV;;271;263;534
6819;SORBOLO MEZZANI;PR;;6312;6407;12719
6820;SORDEVOLO;BI;;637;662;1299
6821;SORDIO;LO;;1724;1663;3387
6822;SORESINA;CR;;4325;4419;8744
6823;SORGA';VR;;1500;1430;2930
6824;SORGONO;NU;;772;757;1529
6825;SORI;GE;;1954;2064;4018
6826;SORIANELLO;VV;;569;529;1098
6827;SORIANO CALABRO;VV;;1145;1161;2306
6828;SORIANO NEL CIMINO;VT;;3940;4081;8021
6829;SORICO;CO;;619;627;1246
6830;SORISO;NO;;348;371;719
6831;SORISOLE;BG;;4447;4454;8901
6832;SORMANO;CO;;355;288;643
6833;SORRADILE;OR;;172;177;349
6834;SORRENTO;NA;;7526;8074;15600
6835;SORSO;SS;;7321;7180;14501
6836;SORTINO;SR;;4105;4193;8298
6837;SOSPIRO;CR;;1546;1504;3050
6838;SOSPIROLO;BL;;1516;1537;3053
6839;SOSSANO;VI;;2131;2054;4185
6840;SOSTEGNO;BI;;355;385;740
6841;SOTTO IL MONTE GIOVANNI XXIII;BG;;2189;2212;4401
6842;SOVER;TN;;406;367;773
6843;SOVERATO;CZ;;4048;4635;8683
6844;SOVERE;BG;;2574;2655;5229
6845;SOVERIA MANNELLI;CZ;;1379;1524;2903
6846;SOVERIA SIMERI;CZ;;712;749;1461
6847;SOVERZENE;BL;;177;187;364
6848;SOVICILLE;SI;;4802;5104;9906
6849;SOVICO;MB;;4089;4225;8314
6850;SOVIZZO;VI;*;4139;4144;8283
6851;SOVRAMONTE;BL;;646;665;1311
6852;SOZZAGO;NO;;515;573;1088
6853;SPADAFORA;ME;;2261;2421;4682
6854;SPADOLA;VV;;401;398;799
6855;SPARANISE;CE;;3506;3714;7220
6856;SPARONE;TO;;452;476;928
6857;SPECCHIA;LE;;2223;2379;4602
6858;SPELLO;PG;;4006;4308;8314
6859;SPERLINGA;EN;;334;363;697
6860;SPERLONGA;LT;;1543;1538;3081
6861;SPERONE;AV;;1784;1876;3660
6862;SPESSA;PV;;264;290;554
6863;SPEZZANO ALBANESE;CS;;3283;3353;6636
6864;SPEZZANO DELLA SILA;CS;;2164;2119;4283
6865;SPIAZZO;TN;;612;634;1246
6866;SPIGNO MONFERRATO;AL;;464;459;923
6867;SPIGNO SATURNIA;LT;;1380;1476;2856
6868;SPILAMBERTO;MO;;6428;6437;12865
6869;SPILIMBERGO;PN;;5755;6071;11826
6870;SPILINGA;VV;;670;675;1345
6871;SPINADESCO;CR;;723;753;1476
6872;SPINAZZOLA;BT;;2908;3119;6027
6873;SPINEA;VE;;13306;14443;27749
6874;SPINEDA;CR;;298;302;600
6875;SPINETE;CB;;591;595;1186
6876;SPINETO SCRIVIA;AL;;182;185;367
6877;SPINETOLI;AP;;3549;3670;7219
6878;SPINO D'ADDA;CR;;3423;3423;6846
6879;SPINONE AL LAGO;BG;;468;497;965
6880;SPINOSO;PZ;;662;693;1355
6881;SPIRANO;BG;;2827;2782;5609
6882;SPOLETO;PG;;17669;18798;36467
6883;SPOLTORE;PE;;9274;9661;18935
6884;SPONGANO;LE;;1673;1817;3490
6885;SPORMAGGIORE;TN;;676;594;1270
6886;SPORMINORE;TN;;341;363;704
6887;SPOTORNO;SV;;1665;1833;3498
6888;SPRESIANO;TV;;6082;6216;12298
6889;SPRIANA;SO;;38;41;79
6890;SQUILLACE;CZ;;1762;1781;3543
6891;SQUINZANO;LE;;6490;6992;13482
6892;STAFFOLO;AN;;1034;1053;2087
6893;STAGNO LOMBARDO;CR;;724;705;1429
6894;STAITI;RC;;89;100;189
6895;STALETTI';CZ;;1169;1151;2320
6896;STANGHELLA;PD;;2045;2093;4138
6897;STARANZANO;GO;;3604;3642;7246
6898;STATTE;TA;;6389;6747;13136
6899;STAZZANO;AL;;1144;1193;2337
6900;STAZZEMA;LU;;1436;1454;2890
6901;STAZZONA;CO;;311;302;613
6902;STEFANACONI;VV;;1163;1182;2345
6903;STELLA;SV;;1495;1442;2937
6904;STELLA CILENTO;SA;;334;351;685
6905;STELLANELLO;SV;;444;408;852
6906;STELVIO/STILFS;BZ;;589;550;1139
6907;STENICO;TN;;608;550;1158
6908;STERNATIA;LE;;1022;1157;2179
6909;STEZZANO;BG;;6592;6747;13339
6910;STIENTA;RO;;1561;1552;3113
6911;STIGLIANO;MT;;1727;1940;3667
6912;STIGNANO;RC;;629;602;1231
6913;STILO;RC;;1231;1173;2404
6914;STIMIGLIANO;RI;;1102;1101;2203
6915;STINTINO;SS;;790;748;1538
6916;STIO;SA;;372;404;776
6917;STORNARA;FG;;2877;2830;5707
6918;STORNARELLA;FG;;2564;2664;5228
6919;STORO;TN;;2194;2329;4523
6920;STRA;VE;;3694;3905;7599
6921;STRADELLA;PV;;5527;5879;11406
6922;STRAMBINELLO;TO;;121;139;260
6923;STRAMBINO;TO;;2952;3128;6080
6924;STRANGOLAGALLI;FR;;1098;1180;2278
6925;STREGNA;UD;;166;138;304
6926;STREMBO;TN;;302;299;601
6927;STRESA;VB;;2223;2404;4627
6928;STREVI;AL;;942;954;1896
6929;STRIANO;NA;;4393;4316;8709
6930;STRONA;BI;;471;496;967
6931;STRONCONE;TR;;2347;2291;4638
6932;STRONGOLI;KR;;3007;3156;6163
6933;STROPPIANA;VC;;571;601;1172
6934;STROPPO;CN;;48;48;96
6935;STROZZA;BG;;563;514;1077
6936;STURNO;AV;;1384;1433;2817
6937;SUARDI;PV;;295;293;588
6938;SUBBIANO;AR;;3139;3135;6274
6939;SUBIACO;RM;;4205;4333;8538
6940;SUCCIVO;CE;;4369;4336;8705
6941;SUEGLIO;LC;;74;67;141
6942;SUELLI;SU;;546;536;1082
6943;SUELLO;LC;;864;901;1765
6944;SUISIO;BG;;1911;1863;3774
6945;SULBIATE;MB;;2229;2188;4417
6946;SULMONA;AQ;;10861;11577;22438
6947;SULZANO;BS;;974;970;1944
6948;SUMIRAGO;VA;;2931;3043;5974
6949;SUMMONTE;AV;;759;753;1512
6950;SUNI;OR;;474;520;994
6951;SUNO;NO;;1343;1363;2706
6952;SUPERSANO;LE;;2064;2117;4181
6953;SUPINO;FR;;2314;2351;4665
6954;SURANO;LE;;726;816;1542
6955;SURBO;LE;;7148;7547;14695
6956;SUSA;TO;;2810;3130;5940
6957;SUSEGANA;TV;;5873;5867;11740
6958;SUSTINENTE;MN;;980;1043;2023
6959;SUTERA;CL;;578;631;1209
6960;SUTRI;VT;;3271;3326;6597
6961;SUTRIO;UD;;606;633;1239
6962;SUVERETO;LI;;1462;1518;2980
6963;SUZZARA;MN;;10385;10457;20842
6964;TACENO;LC;;287;252;539
6965;TADASUNI;OR;;71;70;141
6966;TAGGIA;IM;;6508;7258;13766
6967;TAGLIACOZZO;AQ;;3203;3246;6449
6968;TAGLIO DI PO;RO;;3963;4007;7970
6969;TAGLIOLO MONFERRATO;AL;;761;742;1503
6970;TAIBON AGORDINO;BL;;852;868;1720
6971;TAINO;VA;;1791;1830;3621
6972;TAIPANA;UD;;303;262;565
6973;TALAMELLO;RN;;518;549;1067
6974;TALAMONA;SO;;2273;2350;4623
6975;TALANA;NU;;465;499;964
6976;TALEGGIO;BG;;290;249;539
6977;TALLA;AR;;516;459;975
6978;TALMASSONS;UD;;1927;1951;3878
6979;TAMBRE;BL;;644;641;1285
6980;TAORMINA;ME;;5096;5377;10473
6981;TARANO;RI;;678;699;1377
6982;TARANTA PELIGNA;CH;;169;160;329
6983;TARANTASCA;CN;;1121;1045;2166
6984;TARANTO;TA;;90789;98672;189461
6985;TARCENTO;UD;;4234;4601;8835
6986;TARQUINIA;VT;;7846;8229;16075
6987;TARSIA;CS;;943;935;1878
6988;TARTANO;SO;;109;87;196
6989;TARVISIO;UD;;2040;1957;3997
6990;TARZO;TV;;2073;2153;4226
6991;TASSAROLO;AL;;309;290;599
6992;TAURANO;AV;;725;761;1486
6993;TAURASI;AV;;1085;1106;2191
6994;TAURIANOVA;RC;;7318;7629;14947
6995;TAURISANO;LE;;5447;5898;11345
6996;TAVAGNACCO;UD;;7007;7723;14730
6997;TAVAGNASCO;TO;;359;386;745
6998;TAVAZZANO CON VILLAVESCO;LO;;2907;2990;5897
6999;TAVENNA;CB;;287;315;602
7000;TAVERNA;CZ;;1274;1255;2529
7001;TAVERNERIO;CO;;2785;2915;5700
7002;TAVERNOLA BERGAMASCA;BG;;992;969;1961
7003;TAVERNOLE SUL MELLA;BS;;621;598;1219
7004;TAVIANO;LE;;5528;6023;11551
7005;TAVIGLIANO;BI;;470;467;937
7006;TAVOLETO;PU;;404;427;831
7007;TAVULLIA;PU;;3963;3920;7883
7008;TEANA;PZ;;251;282;533
7009;TEANO;CE;;5609;5839;11448
7010;TEGGIANO;SA;;3465;3721;7186
7011;TEGLIO;SO;;2153;2257;4410
7012;TEGLIO VENETO;VE;;1143;1113;2256
7013;TELESE TERME;BN;;3648;3997;7645
7014;TELGATE;BG;;2624;2354;4978
7015;TELTI;SS;;1121;1115;2236
7016;TELVE;TN;;922;964;1886
7017;TELVE DI SOPRA;TN;;308;290;598
7018;TEMPIO PAUSANIA;SS;;6683;6646;13329
7019;TEMU';BS;;560;545;1105
7020;TENNA;TN;;513;535;1048
7021;TENNO;TN;;957;1027;1984
7022;TEOLO;PD;;4355;4512;8867
7023;TEORA;AV;;739;724;1463
7024;TERAMO;TE;;25033;26816;51849
7025;TERDOBBIATE;NO;;231;228;459
7026;TERELLE;FR;;154;158;312
7027;TERENTO/TERENTEN;BZ;;927;852;1779
7028;TERENZO;PR;;596;566;1162
7029;TERGU;SS;;294;312;606
7030;TERLANO/TERLAN;BZ;;2384;2365;4749
7031;TERLIZZI;BA;;13012;13197;26209
7032;TERME VIGLIATORE;ME;;3556;3660;7216
7033;TERMENO SULLA STRADA DEL VINO/TRAMIN AN DER WEINSTRASSE;BZ;;1683;1713;3396
7034;TERMINI IMERESE;PA;;12255;12827;25082
7035;TERMOLI;CB;;15799;16592;32391
7036;TERNATE;VA;;1211;1274;2485
7037;TERNENGO;BI;;126;134;260
7038;TERNI;TR;;50926;56239;107165
7039;TERNO D'ISOLA;BG;;4030;3986;8016
7040;TERRACINA;LT;;22206;22298;44504
7041;TERRAGNOLO;TN;;364;341;705
7042;TERRALBA;OR;;4940;4852;9792
7043;TERRANOVA DA SIBARI;CS;;2308;2314;4622
7044;TERRANOVA DEI PASSERINI;LO;;464;467;931
7045;TERRANOVA DI POLLINO;PZ;;500;539;1039
7046;TERRANOVA SAPPO MINULIO;RC;;234;226;460
7047;TERRANUOVA BRACCIOLINI;AR;;5931;6052;11983
7048;TERRASINI;PA;;6279;6427;12706
7049;TERRASSA PADOVANA;PD;;1356;1321;2677
7050;TERRAVECCHIA;CS;;297;313;610
7051;TERRAZZO;VR;;1056;1084;2140
7052;TERRE D'ADIGE;TN;;1543;1500;3043
7053;TERRE DEL RENO;FE;;4845;5033;9878
7054;TERRE ROVERESCHE;PU;;2598;2549;5147
7055;TERRICCIOLA;PI;;2211;2249;4460
7056;TERRUGGIA;AL;;428;484;912
7057;TERTENIA;NU;;1922;1933;3855
7058;TERZIGNO;NA;;8688;8568;17256
7059;TERZO;AL;;427;411;838
7060;TERZO D'AQUILEIA;UD;;1322;1407;2729
7061;TERZOLAS;TN;;306;330;636
7062;TERZORIO;IM;;114;121;235
7063;TESERO;TN;;1462;1475;2937
7064;TESIMO/TISENS;BZ;;1004;976;1980
7065;TESSENNANO;VT;;151;137;288
7066;TESTICO;SV;;90;87;177
7067;TETI;NU;;322;288;610
7068;TEULADA;SU;;1704;1596;3300
7069;TEVEROLA;CE;;7223;7428;14651
7070;TEZZE SUL BRENTA;VI;;6431;6460;12891
7071;THIENE;VI;;11676;12269;23945
7072;THIESI;SS;;1413;1401;2814
7073;TIANA;NU;;225;219;444
7074;TICENGO;CR;;205;212;417
7075;TICINETO;AL;;625;682;1307
7076;TIGGIANO;LE;;1373;1380;2753
7077;TIGLIETO;GE;;246;230;476
7078;TIGLIOLE;AT;;852;851;1703
7079;TIGNALE;BS;;550;608;1158
7080;TINNURA;OR;;119;120;239
7081;TIONE DEGLI ABRUZZI;AQ;;138;129;267
7082;TIONE DI TRENTO;TN;;1808;1844;3652
7083;TIRANO;SO;;4236;4587;8823
7084;TIRES/TIERS;BZ;;470;529;999
7085;TIRIOLO;CZ;;1780;1825;3605
7086;TIROLO/TIROL;BZ;;1221;1241;2462
7087;TISSI;SS;;1191;1170;2361
7088;TITO;PZ;;3562;3585;7147
7089;TIVOLI;RM;;27121;28055;55176
7090;TIZZANO VAL PARMA;PR;;1071;1049;2120
7091;TOANO;RE;;2099;2024;4123
7092;TOCCO CAUDIO;BN;;711;729;1440
7093;TOCCO DA CASAURIA;PE;;1195;1227;2422
7094;TOCENO;VB;;374;353;727
7095;TODI;PG;;7636;8153;15789
7096;TOFFIA;RI;;557;532;1089
7097;TOIRANO;SV;;1282;1358;2640
7098;TOLENTINO;MC;;8778;9364;18142
7099;TOLFA;RM;;2409;2380;4789
7100;TOLLEGNO;BI;;1152;1231;2383
7101;TOLLO;CH;;1956;1972;3928
7102;TOLMEZZO;UD;;4720;5171;9891
7103;TOLVE;PZ;;1500;1490;2990
7104;TOMBOLO;PD;;4055;4185;8240
7105;TON;TN;;687;625;1312
7106;TONARA;NU;;896;916;1812
7107;TONCO;AT;;398;376;774
7108;TONEZZA DEL CIMONE;VI;;254;247;501
7109;TORA E PICCILLI;CE;;382;410;792
7110;TORANO CASTELLO;CS;;2156;2187;4343
7111;TORANO NUOVO;TE;;731;759;1490
7112;TORBOLE CASAGLIA;BS;;3215;3186;6401
7113;TORCEGNO;TN;;342;342;684
7114;TORCHIARA;SA;;889;935;1824
7115;TORCHIAROLO;BR;;2576;2665;5241
7116;TORELLA DEI LOMBARDI;AV;;973;997;1970
7117;TORELLA DEL SANNIO;CB;;363;341;704
7118;TORGIANO;PG;;3257;3383;6640
7119;TORGNON;AO;;299;257;556
7120;TORINO;TO;;407062;441686;848748
7121;TORINO DI SANGRO;CH;;1442;1503;2945
7122;TORITTO;BA;;3978;4083;8061
7123;TORLINO VIMERCATI;CR;;236;244;480
7124;TORNACO;NO;;425;450;875
7125;TORNARECCIO;CH;;831;832;1663
7126;TORNATA;CR;;234;192;426
7127;TORNIMPARTE;AQ;;1444;1403;2847
7128;TORNO;CO;;545;561;1106
7129;TORNOLO;PR;;487;428;915
7130;TORO;CB;;608;635;1243
7131;TORPE';NU;;1412;1308;2720
7132;TORRACA;SA;;586;599;1185
7133;TORRALBA;SS;;450;454;904
7134;TORRAZZA COSTE;PV;;780;789;1569
7135;TORRAZZA PIEMONTE;TO;;1479;1521;3000
7136;TORRAZZO;BI;;108;97;205
7137;TORRE ANNUNZIATA;NA;;19508;21015;40523
7138;TORRE BERETTI E CASTELLARO;PV;;270;237;507
7139;TORRE BOLDONE;BG;;4142;4478;8620
7140;TORRE BORMIDA;CN;;79;83;162
7141;TORRE CAJETANI;FR;;672;643;1315
7142;TORRE CANAVESE;TO;;300;320;620
7143;TORRE D'ARESE;PV;;493;436;929
7144;TORRE D'ISOLA;PV;;1181;1206;2387
7145;TORRE DE' BUSI;BG;;1109;1074;2183
7146;TORRE DE' NEGRI;PV;;148;165;313
7147;TORRE DE' PASSERI;PE;;1412;1471;2883
7148;TORRE DE' PICENARDI;CR;;1058;1045;2103
7149;TORRE DE' ROVERI;BG;;1258;1268;2526
7150;TORRE DEL GRECO;NA;;39341;41948;81289
7151;TORRE DI MOSTO;VE;;2377;2389;4766
7152;TORRE DI RUGGIERO;CZ;;452;509;961
7153;TORRE DI SANTA MARIA;SO;;369;376;745
7154;TORRE LE NOCELLE;AV;;600;602;1202
7155;TORRE MONDOVI';CN;;256;233;489
7156;TORRE ORSAIA;SA;;976;1006;1982
7157;TORRE PALLAVICINA;BG;;569;558;1127
7158;TORRE PELLICE;TO;;2185;2406;4591
7159;TORRE SAN GIORGIO;CN;;367;377;744
7160;TORRE SAN PATRIZIO;FM;;921;963;1884
7161;TORRE SANTA SUSANNA;BR;;4954;5197;10151
7162;TORREANO;UD;;1008;1060;2068
7163;TORREBELVICINO;VI;;2952;2865;5817
7164;TORREBRUNA;CH;;338;379;717
7165;TORRECUSO;BN;;1619;1641;3260
7166;TORREGLIA;PD;;3035;3075;6110
7167;TORREGROTTA;ME;;3452;3816;7268
7168;TORREMAGGIORE;FG;;8199;8368;16567
7169;TORRENOVA;ME;;2179;2305;4484
7170;TORRESINA;CN;;21;27;48
7171;TORRETTA;PA;;2056;2145;4201
7172;TORREVECCHIA PIA;PV;;1784;1696;3480
7173;TORREVECCHIA TEATINA;CH;;2092;2114;4206
7174;TORRI DEL BENACO;VR;;1427;1540;2967
7175;TORRI DI QUARTESOLO;VI;;5799;5939;11738
7176;TORRI IN SABINA;RI;;627;594;1221
7177;TORRICE;FR;;2322;2411;4733
7178;TORRICELLA;TA;;2073;2092;4165
7179;TORRICELLA DEL PIZZO;CR;;290;284;574
7180;TORRICELLA IN SABINA;RI;;705;628;1333
7181;TORRICELLA PELIGNA;CH;;546;606;1152
7182;TORRICELLA SICURA;TE;;1228;1232;2460
7183;TORRICELLA VERZATE;PV;;408;408;816
7184;TORRIGLIA;GE;;1081;1114;2195
7185;TORRILE;PR;;3858;3828;7686
7186;TORRIONI;AV;;252;204;456
7187;TORRITA DI SIENA;SI;;3436;3578;7014
7188;TORRITA TIBERINA;RM;;526;553;1079
7189;TORTOLI';NU;;5411;5613;11024
7190;TORTONA;AL;;12746;13715;26461
7191;TORTORA;CS;;2901;3048;5949
7192;TORTORELLA;SA;;231;242;473
7193;TORTORETO;TE;;5735;6111;11846
7194;TORTORICI;ME;;2855;2937;5792
7195;TORVISCOSA;UD;;1293;1355;2648
7196;TOSCOLANO-MADERNO;BS;;3660;3890;7550
7197;TOSSICIA;TE;;600;658;1258
7198;TOVO DI SANT'AGATA;SO;;317;309;626
7199;TOVO SAN GIACOMO;SV;;1221;1283;2504
7200;TRABIA;PA;;5341;5164;10505
7201;TRADATE;VA;;9273;9561;18834
7202;TRAMATZA;OR;;475;462;937
7203;TRAMBILENO;TN;;729;738;1467
7204;TRAMONTI;SA;;2034;2058;4092
7205;TRAMONTI DI SOPRA;PN;;132;139;271
7206;TRAMONTI DI SOTTO;PN;;175;164;339
7207;TRAMUTOLA;PZ;;1434;1507;2941
7208;TRANA;TO;;1873;1940;3813
7209;TRANI;BT;;27247;27788;55035
7210;TRAONA;SO;;1453;1389;2842
7211;TRAPANI;TP;;27168;29125;56293
7212;TRAPPETO;PA;;1514;1541;3055
7213;TRAREGO VIGGIONA;VB;;212;197;409
7214;TRASACCO;AQ;;3006;2891;5897
7215;TRASAGHIS;UD;;1044;1055;2099
7216;TRASQUERA;VB;;89;93;182
7217;TRATALIAS;SU;;525;495;1020
7218;TRAVACO' SICCOMARIO;PV;;2134;2268;4402
7219;TRAVAGLIATO;BS;;6811;6914;13725
7220;TRAVEDONA-MONATE;VA;;1926;2023;3949
7221;TRAVERSELLA;TO;;164;155;319
7222;TRAVERSETOLO;PR;;4686;4768;9454
7223;TRAVES;TO;;252;234;486
7224;TRAVESIO;PN;;881;902;1783
7225;TRAVO;PC;;1083;1082;2165
7226;TRE VILLE;TN;;672;693;1365
7227;TREBASELEGHE;PD;;6475;6414;12889
7228;TREBISACCE;CS;;4180;4413;8593
7229;TRECASE;NA;;4195;4399;8594
7230;TRECASTAGNI;CT;;5555;5675;11230
7231;TRECASTELLI;AN;;3737;3705;7442
7232;TRECATE;NO;;10237;10259;20496
7233;TRECCHINA;PZ;;1040;1142;2182
7234;TRECENTA;RO;;1255;1336;2591
7235;TREDOZIO;FC;;547;574;1121
7236;TREGLIO;CH;;844;886;1730
7237;TREGNAGO;VR;;2437;2532;4969
7238;TREIA;MC;;4516;4577;9093
7239;TREISO;CN;;388;373;761
7240;TREMESTIERI ETNEO;CT;;9414;10437;19851
7241;TREMEZZINA;CO;;2482;2545;5027
7242;TREMOSINE SUL GARDA;BS;;1035;1011;2046
7243;TRENTINARA;SA;;786;786;1572
7244;TRENTO;TN;;57025;60822;117847
7245;TRENTOLA DUCENTA;CE;;9897;10240;20137
7246;TRENZANO;BS;;2763;2707;5470
7247;TREPPO GRANDE;UD;;818;881;1699
7248;TREPPO LIGOSULLO;UD;;346;336;682
7249;TREPUZZI;LE;;6742;7357;14099
7250;TREQUANDA;SI;;594;601;1195
7251;TRESANA;MS;;968;984;1952
7252;TRESCORE BALNEARIO;BG;;4870;4841;9711
7253;TRESCORE CREMASCO;CR;;1374;1420;2794
7254;TRESIGNANA;FE;;3333;3618;6951
7255;TRESIVIO;SO;;999;1012;2011
7256;TRESNURAGHES;OR;;509;542;1051
7257;TREVENZUOLO;VR;;1428;1329;2757
7258;TREVI;PG;;3954;4173;8127
7259;TREVI NEL LAZIO;FR;;909;840;1749
7260;TREVICO;AV;;425;442;867
7261;TREVIGLIO;BG;;15018;15549;30567
7262;TREVIGNANO;TV;;5375;5347;10722
7263;TREVIGNANO ROMANO;RM;;2839;2993;5832
7264;TREVILLE;AL;;126;132;258
7265;TREVIOLO;BG;;5294;5563;10857
7266;TREVISO;TV;;40387;44065;84452
7267;TREVISO BRESCIANO;BS;;249;258;507
7268;TREZZANO ROSA;MI;;2685;2689;5374
7269;TREZZANO SUL NAVIGLIO;MI;;10462;10998;21460
7270;TREZZO SULL'ADDA;MI;;5835;6095;11930
7271;TREZZO TINELLA;CN;;162;141;303
7272;TREZZONE;CO;;124;113;237
7273;TRIBANO;PD;;2135;2112;4247
7274;TRIBIANO;MI;;1865;1807;3672
7275;TRIBOGNA;GE;;296;270;566
7276;TRICARICO;MT;;2380;2477;4857
7277;TRICASE;LE;;8269;8873;17142
7278;TRICERRO;VC;;347;333;680
7279;TRICESIMO;UD;;3619;3977;7596
7280;TRIEI;NU;;546;525;1071
7281;TRIESTE;TS;;95818;103197;199015
7282;TRIGGIANO;BA;;12621;13492;26113
7283;TRIGOLO;CR;;786;852;1638
7284;TRINITA';CN;;1104;1127;2231
7285;TRINITA' D'AGULTU E VIGNOLA;SS;;1106;1133;2239
7286;TRINITAPOLI;BT;;6814;7156;13970
7287;TRINO;VC;;3312;3380;6692
7288;TRIORA;IM;;207;153;360
7289;TRIPI;ME;;348;407;755
7290;TRISOBBIO;AL;;331;336;667
7291;TRISSINO;VI;;4335;4303;8638
7292;TRIUGGIO;MB;;4316;4352;8668
7293;TRIVENTO;CB;;2196;2241;4437
7294;TRIVIGLIANO;FR;;803;828;1631
7295;TRIVIGNANO UDINESE;UD;;774;790;1564
7296;TRIVIGNO;PZ;;283;305;588
7297;TRIVOLZIO;PV;;1207;1157;2364
7298;TRODENA NEL PARCO NATURALE/TRUDEN IM NATURPARK;BZ;;514;531;1045
7299;TROFARELLO;TO;;5133;5447;10580
7300;TROIA;FG;;3287;3484;6771
7301;TROINA;EN;;4177;4465;8642
7302;TROMELLO;PV;;1785;1862;3647
7303;TRONTANO;VB;;821;811;1632
7304;TRONZANO LAGO MAGGIORE;VA;;117;108;225
7305;TRONZANO VERCELLESE;VC;;1623;1695;3318
7306;TROPEA;VV;;2842;3069;5911
7307;TROVO;PV;;524;493;1017
7308;TRUCCAZZANO;MI;;3012;2832;5844
7309;TUBRE/TAUFERS IM MUNSTERTAL;BZ;;462;500;962
7310;TUFARA;CB;;391;407;798
7311;TUFILLO;CH;;171;186;357
7312;TUFINO;NA;;1693;1734;3427
7313;TUFO;AV;;395;400;795
7314;TUGLIE;LE;;2440;2627;5067
7315;TUILI;SU;;466;482;948
7316;TULA;SS;;742;724;1466
7317;TUORO SUL TRASIMENO;PG;;1833;1910;3743
7318;TURANIA;RI;;133;90;223
7319;TURANO LODIGIANO;LO;;762;738;1500
7320;TURATE;CO;;4771;4784;9555
7321;TURBIGO;MI;;3467;3579;7046
7322;TURI;BA;;6270;6658;12928
7323;TURRI;SU;;200;191;391
7324;TURRIACO;GO;;1375;1431;2806
7325;TURRIVALIGNANI;PE;;383;407;790
7326;TURSI;MT;;2384;2369;4753
7327;TUSA;ME;;1319;1319;2638
7328;TUSCANIA;VT;;3970;4272;8242
7329;UBIALE CLANEZZO;BG;;696;657;1353
7330;UBOLDO;VA;;5371;5348;10719
7331;UCRIA;ME;;432;492;924
7332;UDINE;UD;;45971;51765;97736
7333;UGENTO;LE;;5816;6259;12075
7334;UGGIANO LA CHIESA;LE;;2067;2280;4347
7335;UGGIATE CON RONAGO;CO;*;3279;3388;6667
7336;ULA TIRSO;OR;;230;245;475
7337;ULASSAI;NU;;661;708;1369
7338;ULTIMO/ULTEN;BZ;;1472;1425;2897
7339;UMBERTIDE;PG;;7982;8376;16358
7340;UMBRIATICO;KR;;377;378;755
7341;URAGO D'OGLIO;BS;;1929;1804;3733
7342;URAS;OR;;1346;1351;2697
7343;URBANA;PD;;1016;1028;2044
7344;URBANIA;PU;;3351;3537;6888
7345;URBE;SV;;330;323;653
7346;URBINO;PU;;6797;6975;13772
7347;URBISAGLIA;MC;;1210;1229;2439
7348;URGNANO;BG;;5008;4813;9821
7349;URI;SS;;1471;1385;2856
7350;URURI;CB;;1188;1282;2470
7351;URZULEI;NU;;565;560;1125
7352;USCIO;GE;;1059;1082;2141
7353;USELLUS;OR;;372;355;727
7354;USINI;SS;;2125;2112;4237
7355;USMATE VELATE;MB;;5190;5293;10483
7356;USSANA;SU;;1999;2024;4023
7357;USSARAMANNA;SU;;253;239;492
7358;USSASSAI;NU;;242;231;473
7359;USSEAUX;TO;;90;88;178
7360;USSEGLIO;TO;;103;92;195
7361;USSITA;MC;;184;194;378
7362;USTICA;PA;;660;647;1307
7363;UTA;CA;;4413;4258;8671
7364;UZZANO;PT;;2712;2897;5609
7365;VACCARIZZO ALBANESE;CS;;498;531;1029
7366;VACONE;RI;;113;113;226
7367;VACRI;CH;;747;779;1526
7368;VADENA/PFATTEN;BZ;;573;503;1076
7369;VADO LIGURE;SV;;3916;4189;8105
7370;VAGLI SOTTO;LU;;438;401;839
7371;VAGLIA;FI;;2547;2661;5208
7372;VAGLIO BASILICATA;PZ;;909;971;1880
7373;VAGLIO SERRA;AT;;136;140;276
7374;VAIANO;PO;;4842;5101;9943
7375;VAIANO CREMASCO;CR;;1795;1759;3554
7376;VAIE;TO;;687;702;1389
7377;VAILATE;CR;;2306;2294;4600
7378;VAIRANO PATENORA;CE;;3050;3257;6307
7379;VAJONT;PN;;835;834;1669
7380;VAL BREMBILLA;BG;;2102;2054;4156
7381;VAL DELLA TORRE;TO;;2011;1971;3982
7382;VAL DI CHY;TO;;633;602;1235
7383;VAL DI NIZZA;PV;;288;291;579
7384;VAL DI VIZZE/PFITSCH;BZ;;1535;1530;3065
7385;VAL DI ZOLDO;BL;;1377;1440;2817
7386;VAL LIONA;VI;;1567;1493;3060
7387;VAL MASINO;SO;;444;397;841
7388;VAL REZZO;CO;;82;80;162
7389;VALBONDIONE;BG;;482;486;968
7390;VALBREMBO;BG;;2147;2205;4352
7391;VALBRENTA;VI;;2502;2368;4870
7392;VALBREVENNA;GE;;420;337;757
7393;VALBRONA;CO;;1304;1321;2625
7394;VALCHIUSA;TO;;485;518;1003
7395;VALDAGNO;VI;;12481;13216;25697
7396;VALDAONE;TN;;600;549;1149
7397;VALDAORA/OLANG;BZ;;1618;1548;3166
7398;VALDASTICO;VI;;565;610;1175
7399;VALDENGO;BI;;1174;1222;2396
7400;VALDERICE;TP;;5719;5832;11551
7401;VALDIDENTRO;SO;;2090;2044;4134
7402;VALDIERI;CN;;460;452;912
7403;VALDILANA;BI;;4989;5246;10235
7404;VALDINA;ME;;629;639;1268
7405;VALDISOTTO;SO;;1817;1777;3594
7406;VALDOBBIADENE;TV;;4838;5164;10002
7407;VALDUGGIA;VC;;926;949;1875
7408;VALEGGIO;PV;;108;87;195
7409;VALEGGIO SUL MINCIO;VR;;7851;8006;15857
7410;VALENTANO;VT;;1374;1388;2762
7411;VALENZA;AL;;8627;9463;18090
7412;VALENZANO;BA;;8484;8973;17457
7413;VALERA FRATTA;LO;;882;848;1730
7414;VALFABBRICA;PG;;1588;1658;3246
7415;VALFENERA;AT;;1227;1189;2416
7416;VALFLORIANA;TN;;241;233;474
7417;VALFORNACE;MC;;456;465;921
7418;VALFURVA;SO;;1240;1258;2498
7419;VALGANNA;VA;;792;803;1595
7420;VALGIOIE;TO;;530;446;976
7421;VALGOGLIO;BG;;299;286;585
7422;VALGRANA;CN;;413;395;808
7423;VALGREGHENTINO;LC;;1718;1687;3405
7424;VALGRISENCHE;AO;;111;81;192
7425;VALGUARNERA CAROPEPE;EN;;3322;3760;7082
7426;VALLADA AGORDINA;BL;;220;246;466
7427;VALLANZENGO;BI;;100;106;206
7428;VALLARSA;TN;;706;677;1383
7429;VALLATA;AV;;1249;1291;2540
7430;VALLE AGRICOLA;CE;;373;393;766
7431;VALLE AURINA/AHRNTAL;BZ;;3069;2920;5989
7432;VALLE CANNOBINA;VB;;239;226;465
7433;VALLE CASTELLANA;TE;;470;410;880
7434;VALLE DELL'ANGELO;SA;;115;105;220
7435;VALLE DI CADORE;BL;;900;962;1862
7436;VALLE DI CASIES/GSIES;BZ;;1185;1154;2339
7437;VALLE DI MADDALONI;CE;;1298;1345;2643
7438;VALLE LOMELLINA;PV;;1057;1009;2066
7439;VALLE SALIMBENE;PV;;729;722;1451
7440;VALLE SAN NICOLAO;BI;;443;438;881
7441;VALLEBONA;IM;;642;615;1257
7442;VALLECORSA;FR;;1199;1239;2438
7443;VALLECROSIA;IM;;3185;3542;6727
7444;VALLEDOLMO;PA;;1548;1679;3227
7445;VALLEDORIA;SS;;2150;2114;4264
7446;VALLEFIORITA;CZ;;714;817;1531
7447;VALLEFOGLIA;PU;;7514;7403;14917
7448;VALLELAGHI;TN;;2606;2570;5176
7449;VALLELONGA;VV;;372;347;719
7450;VALLELUNGA PRATAMENO;CL;;1505;1659;3164
7451;VALLEMAIO;FR;;437;455;892
7452;VALLEPIETRA;RM;;117;131;248
7453;VALLERANO;VT;;1210;1232;2442
7454;VALLERMOSA;SU;;929;881;1810
7455;VALLEROTONDA;FR;;704;710;1414
7456;VALLESACCARDA;AV;;609;641;1250
7457;VALLEVE;BG;;71;56;127
7458;VALLI DEL PASUBIO;VI;;1569;1495;3064
7459;VALLINFREDA;RM;;158;140;298
7460;VALLIO TERME;BS;;706;704;1410
7461;VALLO DELLA LUCANIA;SA;;3823;4261;8084
7462;VALLO DI NERA;PG;;165;175;340
7463;VALLO TORINESE;TO;;397;383;780
7464;VALLORIATE;CN;;55;44;99
7465;VALMACCA;AL;;455;511;966
7466;VALMADRERA;LC;;5480;5681;11161
7467;VALMONTONE;RM;;7763;7935;15698
7468;VALMOREA;CO;;1271;1312;2583
7469;VALMOZZOLA;PR;;269;261;530
7470;VALNEGRA;BG;;111;104;215
7471;VALPELLINE;AO;;314;277;591
7472;VALPERGA;TO;;1415;1559;2974
7473;VALPRATO SOANA;TO;;49;41;90
7474;VALSAMOGGIA;BO;;15707;15898;31605
7475;VALSAVARENCHE;AO;;87;79;166
7476;VALSINNI;MT;;662;711;1373
7477;VALSOLDA;CO;;702;724;1426
7478;VALSTRONA;VB;;581;582;1163
7479;VALTOPINA;PG;;616;655;1271
7480;VALTORTA;BG;;131;118;249
7481;VALTOURNENCHE;AO;;1157;1041;2198
7482;VALVA;SA;;785;766;1551
7483;VALVARRONE;LC;;262;246;508
7484;VALVASONE ARZENE;PN;;1951;1966;3917
7485;VALVERDE;CT;;3884;3954;7838
7486;VALVESTINO;BS;;84;89;173
7487;VANDOIES/VINTL;BZ;;1678;1630;3308
7488;VANZAGHELLO;MI;;2565;2697;5262
7489;VANZAGO;MI;;4545;4782;9327
7490;VANZONE CON SAN CARLO;VB;;195;195;390
7491;VAPRIO D'ADDA;MI;;4770;4692;9462
7492;VAPRIO D'AGOGNA;NO;;470;497;967
7493;VARALLO;VC;;3317;3609;6926
7494;VARALLO POMBIA;NO;;2416;2530;4946
7495;VARANO BORGHI;VA;;1175;1280;2455
7496;VARANO DE' MELEGARI;PR;;1283;1309;2592
7497;VARAPODIO;RC;;984;1013;1997
7498;VARAZZE;SV;;6099;6521;12620
7499;VARCO SABINO;RI;;92;73;165
7500;VAREDO;MB;;6631;6988;13619
7501;VARENNA;LC;;367;358;725
7502;VARESE;VA;;37414;41326;78740
7503;VARESE LIGURE;SP;;895;916;1811
7504;VARISELLA;TO;;426;424;850
7505;VARMO;UD;;1335;1307;2642
7506;VARNA/VAHRN;BZ;;2477;2417;4894
7507;VARSI;PR;;568;570;1138
7508;VARZI;PV;;1470;1543;3013
7509;VARZO;VB;;941;999;1940
7510;VASANELLO;VT;;1965;2014;3979
7511;VASIA;IM;;179;187;366
7512;VASTO;CH;;19799;20766;40565
7513;VASTOGIRARDI;IS;;322;312;634
7514;VAUDA CANAVESE;TO;;726;709;1435
7515;VAZZANO;VV;;458;506;964
7516;VAZZOLA;TV;;3405;3341;6746
7517;VECCHIANO;PI;;5765;6145;11910
7518;VEDANO AL LAMBRO;MB;;3580;3924;7504
7519;VEDANO OLONA;VA;;3497;3784;7281
7520;VEDELAGO;TV;;8347;8207;16554
7521;VEDESETA;BG;;101;86;187
7522;VEDUGGIO CON COLZANO;MB;;2120;2096;4216
7523;VEGGIANO;PD;;2441;2361;4802
7524;VEGLIE;LE;;6496;6925;13421
7525;VEGLIO;BI;;234;220;454
7526;VEJANO;VT;;1074;1080;2154
7527;VELESO;CO;;102;101;203
7528;VELEZZO LOMELLINA;PV;;51;45;96
7529;VELLETRI;RM;;25655;26817;52472
7530;VELLEZZO BELLINI;PV;;1687;1657;3344
7531;VELO D'ASTICO;VI;;1114;1130;2244
7532;VELO VERONESE;VR;;408;363;771
7533;VELTURNO/FELDTHURNS;BZ;;1549;1500;3049
7534;VENAFRO;IS;;5391;5615;11006
7535;VENARIA REALE;TO;;15704;16758;32462
7536;VENAROTTA;AP;;956;958;1914
7537;VENASCA;CN;;657;691;1348
7538;VENAUS;TO;;439;432;871
7539;VENDONE;SV;;179;187;366
7540;VENEGONO INFERIORE;VA;;2905;3047;5952
7541;VENEGONO SUPERIORE;VA;;3584;3673;7257
7542;VENETICO;ME;;1870;2048;3918
7543;VENEZIA;VE;;120714;131230;251944
7544;VENIANO;CO;;1510;1568;3078
7545;VENOSA;PZ;;5472;5563;11035
7546;VENTASSO;RE;;1968;1996;3964
7547;VENTICANO;AV;;1121;1168;2289
7548;VENTIMIGLIA;IM;;11292;11726;23018
7549;VENTIMIGLIA DI SICILIA;PA;;909;942;1851
7550;VENTOTENE;LT;;389;315;704
7551;VENZONE;UD;;979;974;1953
7552;VERANO BRIANZA;MB;;4506;4665;9171
7553;VERANO/VORAN;BZ;;517;468;985
7554;VERBANIA;VB;;14153;15703;29856
7555;VERBICARO;CS;;1326;1348;2674
7556;VERCANA;CO;;371;372;743
7557;VERCEIA;SO;;522;541;1063
7558;VERCELLI;VC;;21661;23515;45176
7559;VERCURAGO;LC;;1303;1431;2734
7560;VERDELLINO;BG;;3912;3597;7509
7561;VERDELLO;BG;;4144;3974;8118
7562;VERDERIO;LC;;2761;2747;5508
7563;VERDUNO;CN;;268;294;562
7564;VERGATO;BO;;3746;3775;7521
7565;VERGHERETO;FC;;891;872;1763
7566;VERGIATE;VA;;4252;4400;8652
7567;VERMEZZO CON ZELO;MI;;2876;2955;5831
7568;VERMIGLIO;TN;;885;910;1795
7569;VERNANTE;CN;;531;573;1104
7570;VERNASCA;PC;;1011;989;2000
7571;VERNATE;MI;;1687;1645;3332
7572;VERNAZZA;SP;;373;386;759
7573;VERNIO;PO;;3013;3053;6066
7574;VERNOLE;LE;;3243;3531;6774
7575;VEROLANUOVA;BS;;3985;4033;8018
7576;VEROLAVECCHIA;BS;;1922;1832;3754
7577;VEROLENGO;TO;;2331;2451;4782
7578;VEROLI;FR;;9799;10050;19849
7579;VERONA;VR;;122107;133878;255985
7580;VERONELLA;VR;;2614;2526;5140
7581;VERRAYES;AO;;656;638;1294
7582;VERRETTO;PV;;194;183;377
7583;VERRONE;BI;;587;590;1177
7584;VERRUA PO;PV;;576;611;1187
7585;VERRUA SAVOIA;TO;;678;663;1341
7586;VERRES;AO;;1276;1302;2578
7587;VERTEMATE CON MINOPRIO;CO;;2033;2085;4118
7588;VERTOVA;BG;;2174;2269;4443
7589;VERUCCHIO;RN;;5048;4997;10045
7590;VERVIO;SO;;103;99;202
7591;VERZEGNIS;UD;;427;411;838
7592;VERZINO;KR;;766;850;1616
7593;VERZUOLO;CN;;3196;3221;6417
7594;VESCOVANA;PD;;847;873;1720
7595;VESCOVATO;CR;;1907;1910;3817
7596;VESIME;AT;;310;282;592
7597;VESPOLATE;NO;;1002;1013;2015
7598;VESSALICO;IM;;132;115;247
7599;VESTENANOVA;VR;;1297;1201;2498
7600;VESTIGNE';TO;;375;378;753
7601;VESTONE;BS;;2084;2097;4181
7602;VETRALLA;VT;;6547;6837;13384
7603;VETTO;RE;;926;858;1784
7604;VEZZA D'ALBA;CN;;1192;1160;2352
7605;VEZZA D'OGLIO;BS;;734;739;1473
7606;VEZZANO LIGURE;SP;;3517;3695;7212
7607;VEZZANO SUL CROSTOLO;RE;;2099;2199;4298
7608;VEZZI PORTIO;SV;;396;399;795
7609;VIADANA;MN;;9930;9851;19781
7610;VIADANICA;BG;;561;562;1123
7611;VIAGRANDE;CT;;4310;4479;8789
7612;VIALE;AT;;126;124;250
7613;VIALFRE';TO;;129;128;257
7614;VIANO;RE;;1662;1676;3338
7615;VIAREGGIO;LU;;29190;31855;61045
7616;VIARIGI;AT;;434;434;868
7617;VIBO VALENTIA;VV;;15254;16226;31480
7618;VIBONATI;SA;;1598;1617;3215
7619;VICALVI;FR;;351;392;743
7620;VICARI;PA;;1181;1280;2461
7621;VICCHIO;FI;;4009;4013;8022
7622;VICENZA;VI;;52852;57441;110293
7623;VICO DEL GARGANO;FG;;3613;3740;7353
7624;VICO EQUENSE;NA;;9940;10423;20363
7625;VICO NEL LAZIO;FR;;1015;1057;2072
7626;VICOFORTE;CN;;1557;1611;3168
7627;VICOLI;PE;;188;193;381
7628;VICOLUNGO;NO;;399;427;826
7629;VICOPISANO;PI;;4134;4419;8553
7630;VICOVARO;RM;;1786;1838;3624
7631;VIDDALBA;SS;;809;814;1623
7632;VIDIGULFO;PV;;3263;3292;6555
7633;VIDOR;TV;;1829;1861;3690
7634;VIDRACCO;TO;;228;254;482
7635;VIESTE;FG;;6673;6761;13434
7636;VIETRI DI POTENZA;PZ;;1329;1354;2683
7637;VIETRI SUL MARE;SA;;3624;3694;7318
7638;VIGANO SAN MARTINO;BG;;673;649;1322
7639;VIGANO';LC;;1044;1049;2093
7640;VIGARANO MAINARDA;FE;;3726;3845;7571
7641;VIGASIO;VR;;5143;5077;10220
7642;VIGEVANO;PV;;30184;32017;62201
7643;VIGGIANELLO;PZ;;1379;1379;2758
7644;VIGGIANO;PZ;;1675;1609;3284
7645;VIGGIU';VA;;2451;2716;5167
7646;VIGLIANO BIELLESE;BI;;3636;3960;7596
7647;VIGLIANO D'ASTI;AT;;410;406;816
7648;VIGNALE MONFERRATO;AL;;445;498;943
7649;VIGNANELLO;VT;;2125;2174;4299
7650;VIGNATE;MI;;4571;4682;9253
7651;VIGNOLA;MO;;12517;13169;25686
7652;VIGNOLA-FALESINA;TN;;99;82;181
7653;VIGNOLE BORBERA;AL;;982;1040;2022
7654;VIGNOLO;CN;;1310;1333;2643
7655;VIGNONE;VB;;591;604;1195
7656;VIGO DI CADORE;BL;;663;695;1358
7657;VIGODARZERE;PD;;6443;6661;13104
7658;VIGOLO;BG;;291;286;577
7659;VIGOLZONE;PC;;2097;2121;4218
7660;VIGONE;TO;;2531;2555;5086
7661;VIGONOVO;VE;;4875;5015;9890
7662;VIGONZA;PD;;11288;11794;23082
7663;VIGUZZOLO;AL;;1529;1525;3054
7664;VILLA BARTOLOMEA;VR;;2877;2905;5782
7665;VILLA BASILICA;LU;;735;756;1491
7666;VILLA BISCOSSI;PV;;25;36;61
7667;VILLA CARCINA;BS;;5283;5411;10694
7668;VILLA CASTELLI;BR;;4504;4575;9079
7669;VILLA CELIERA;PE;;269;287;556
7670;VILLA COLLEMANDINA;LU;;611;604;1215
7671;VILLA CORTESE;MI;;3038;3137;6175
7672;VILLA D'ADDA;BG;;2254;2321;4575
7673;VILLA D'ALME';BG;;3250;3323;6573
7674;VILLA D'OGNA;BG;;870;912;1782
7675;VILLA DEL BOSCO;BI;;147;169;316
7676;VILLA DEL CONTE;PD;;2832;2730;5562
7677;VILLA DI BRIANO;CE;;3670;3638;7308
7678;VILLA DI CHIAVENNA;SO;;503;464;967
7679;VILLA DI SERIO;BG;;3307;3323;6630
7680;VILLA DI TIRANO;SO;;1484;1512;2996
7681;VILLA ESTENSE;PD;;1054;1051;2105
7682;VILLA FARALDI;IM;;223;225;448
7683;VILLA GUARDIA;CO;;3840;4037;7877
7684;VILLA LAGARINA;TN;;1952;1929;3881
7685;VILLA LATINA;FR;;582;574;1156
7686;VILLA LITERNO;CE;;6372;5959;12331
7687;VILLA MINOZZO;RE;;1794;1723;3517
7688;VILLA SAN GIOVANNI;RC;;6309;6611;12920
7689;VILLA SAN GIOVANNI IN TUSCIA;VT;;613;589;1202
7690;VILLA SAN PIETRO;CA;;1095;1070;2165
7691;VILLA SAN SECONDO;AT;;184;195;379
7692;VILLA SANT'ANGELO;AQ;;234;251;485
7693;VILLA SANT'ANTONIO;OR;;166;167;333
7694;VILLA SANTA LUCIA;FR;;1272;1257;2529
7695;VILLA SANTA LUCIA DEGLI ABRUZZI;AQ;;48;43;91
7696;VILLA SANTA MARIA;CH;;563;557;1120
7697;VILLA SANTINA;UD;;1013;1157;2170
7698;VILLA SANTO STEFANO;FR;;814;837;1651
7699;VILLA VERDE;OR;;139;149;288
7700;VILLABASSA/NIEDERDORF;BZ;;806;775;1581
7701;VILLABATE;PA;;9688;10043;19731
7702;VILLACHIARA;BS;;689;671;1360
7703;VILLACIDRO;SU;;6624;6693;13317
7704;VILLADEATI;AL;;239;242;481
7705;VILLADOSE;RO;;2346;2450;4796
7706;VILLADOSSOLA;VB;;3015;3218;6233
7707;VILLAFALLETTO;CN;;1424;1435;2859
7708;VILLAFRANCA D'ASTI;AT;;1441;1489;2930
7709;VILLAFRANCA DI VERONA;VR;;16255;16789;33044
7710;VILLAFRANCA IN LUNIGIANA;MS;;2299;2312;4611
7711;VILLAFRANCA PADOVANA;PD;;5150;5365;10515
7712;VILLAFRANCA PIEMONTE;TO;;2252;2310;4562
7713;VILLAFRANCA SICULA;AG;;649;696;1345
7714;VILLAFRANCA TIRRENA;ME;;3834;4314;8148
7715;VILLAFRATI;PA;;1511;1572;3083
7716;VILLAGA;VI;;940;932;1872
7717;VILLAGRANDE STRISAILI;NU;;1519;1492;3011
7718;VILLALAGO;AQ;;256;264;520
7719;VILLALBA;CL;;701;745;1446
7720;VILLALFONSINA;CH;;451;446;897
7721;VILLALVERNIA;AL;;430;446;876
7722;VILLAMAGNA;CH;;1084;1088;2172
7723;VILLAMAINA;AV;;435;481;916
7724;VILLAMAR;SU;;1258;1214;2472
7725;VILLAMARZANA;RO;;584;564;1148
7726;VILLAMASSARGIA;SU;;1716;1724;3440
7727;VILLAMIROGLIO;AL;;152;147;299
7728;VILLANDRO/VILLANDERS;BZ;;979;913;1892
7729;VILLANOVA BIELLESE;BI;;91;91;182
7730;VILLANOVA CANAVESE;TO;;582;623;1205
7731;VILLANOVA D'ALBENGA;SV;;1376;1388;2764
7732;VILLANOVA D'ARDENGHI;PV;;387;383;770
7733;VILLANOVA D'ASTI;AT;;2695;2802;5497
7734;VILLANOVA DEL BATTISTA;AV;;715;763;1478
7735;VILLANOVA DEL GHEBBO;RO;;999;984;1983
7736;VILLANOVA DEL SILLARO;LO;;974;876;1850
7737;VILLANOVA DI CAMPOSAMPIERO;PD;;3061;3050;6111
7738;VILLANOVA MARCHESANA;RO;;448;431;879
7739;VILLANOVA MONDOVI';CN;;2865;2954;5819
7740;VILLANOVA MONFERRATO;AL;;840;908;1748
7741;VILLANOVA MONTELEONE;SS;;1055;1069;2124
7742;VILLANOVA SOLARO;CN;;379;356;735
7743;VILLANOVA SULL'ARDA;PC;;850;834;1684
7744;VILLANOVA TRUSCHEDU;OR;;135;158;293
7745;VILLANOVA TULO;SU;;535;484;1019
7746;VILLANOVAFORRU;SU;;326;296;622
7747;VILLANOVAFRANCA;SU;;614;587;1201
7748;VILLANTERIO;PV;;1684;1640;3324
7749;VILLANUOVA SUL CLISI;BS;;2853;2981;5834
7750;VILLAPERUCCIO;SU;;495;515;1010
7751;VILLAPIANA;CS;;2687;2752;5439
7752;VILLAPUTZU;SU;;2221;2288;4509
7753;VILLAR DORA;TO;;1396;1399;2795
7754;VILLAR FOCCHIARDO;TO;;955;1000;1955
7755;VILLAR PELLICE;TO;;523;524;1047
7756;VILLAR PEROSA;TO;;1894;2004;3898
7757;VILLAR SAN COSTANZO;CN;;793;748;1541
7758;VILLARBASSE;TO;;1682;1818;3500
7759;VILLARBOIT;VC;;191;195;386
7760;VILLAREGGIA;TO;;489;507;996
7761;VILLARICCA;NA;;15208;16076;31284
7762;VILLAROMAGNANO;AL;;323;330;653
7763;VILLAROSA;EN;;2109;2341;4450
7764;VILLASALTO;SU;;501;488;989
7765;VILLASANTA;MB;;6779;7289;14068
7766;VILLASIMIUS;SU;;1871;1834;3705
7767;VILLASOR;SU;;3291;3308;6599
7768;VILLASPECIOSA;SU;;1261;1275;2536
7769;VILLASTELLONE;TO;;2175;2297;4472
7770;VILLATA;VC;;774;776;1550
7771;VILLAURBANA;OR;;745;745;1490
7772;VILLAVALLELONGA;AQ;;400;436;836
7773;VILLAVERLA;VI;;3064;2983;6047
7774;VILLE D'ANAUNIA;TN;;2354;2375;4729
7775;VILLE DI FIEMME;TN;;1323;1314;2637
7776;VILLENEUVE;AO;;684;594;1278
7777;VILLESSE;GO;;810;830;1640
7778;VILLETTA BARREA;AQ;;305;284;589
7779;VILLETTE;VB;;134;139;273
7780;VILLIMPENTA;MN;;1031;1062;2093
7781;VILLONGO;BG;;4129;3898;8027
7782;VILLORBA;TV;;8543;9060;17603
7783;VILMINORE DI SCALVE;BG;;710;731;1441
7784;VIMERCATE;MB;;12471;13312;25783
7785;VIMODRONE;MI;;8158;8595;16753
7786;VINADIO;CN;;308;291;599
7787;VINCHIATURO;CB;;1642;1654;3296
7788;VINCHIO;AT;;282;266;548
7789;VINCI;FI;;7134;7440;14574
7790;VINOVO;TO;;7411;7743;15154
7791;VINZAGLIO;NO;;288;235;523
7792;VIOLA;CN;;186;173;359
7793;VIONE;BS;;302;325;627
7794;VIPITENO/STERZING;BZ;;3475;3493;6968
7795;VIRLE PIEMONTE;TO;;585;568;1153
7796;VISANO;BS;;1009;983;1992
7797;VISCHE;TO;;589;607;1196
7798;VISCIANO;NA;;2068;2131;4199
7799;VISCO;UD;;388;428;816
7800;VISONE;AL;;590;548;1138
7801;VISSO;MC;;478;518;996
7802;VISTARINO;PV;;771;747;1518
7803;VISTRORIO;TO;;243;263;506
7804;VITA;TP;;896;926;1822
7805;VITERBO;VT;;32103;33828;65931
7806;VITICUSO;FR;;147;157;304
7807;VITO D'ASIO;PN;;356;364;720
7808;VITORCHIANO;VT;;2601;2648;5249
7809;VITTORIA;RG;;31472;31061;62533
7810;VITTORIO VENETO;TV;;13101;14209;27310
7811;VITTORITO;AQ;;385;437;822
7812;VITTUONE;MI;;4563;4711;9274
7813;VITULANO;BN;;1417;1317;2734
7814;VITULAZIO;CE;;3653;3907;7560
7815;VIU';TO;;529;494;1023
7816;VIVARO;PN;;680;612;1292
7817;VIVARO ROMANO;RM;;91;74;165
7818;VIVERONE;BI;;651;702;1353
7819;VIZZINI;CT;;2758;2989;5747
7820;VIZZOLA TICINO;VA;;307;279;586
7821;VIZZOLO PREDABISSI;MI;;1881;1971;3852
7822;VO';PD;;1620;1663;3283
7823;VOBARNO;BS;;4182;4075;8257
7824;VOBBIA;GE;;193;172;365
7825;VOCCA;VC;;84;73;157
7826;VODO CADORE;BL;;392;430;822
7827;VOGHERA;PV;;18458;19858;38316
7828;VOGHIERA;FE;;1769;1864;3633
7829;VOGOGNA;VB;;864;843;1707
7830;VOLANO;TN;;1551;1512;3063
7831;VOLLA;NA;;12497;12872;25369
7832;VOLONGO;CR;;242;221;463
7833;VOLPAGO DEL MONTELLO;TV;;4973;5089;10062
7834;VOLPARA;PV;;69;55;124
7835;VOLPEDO;AL;;567;590;1157
7836;VOLPEGLINO;AL;;69;65;134
7837;VOLPIANO;TO;;7472;7727;15199
7838;VOLTA MANTOVANA;MN;;3543;3662;7205
7839;VOLTAGGIO;AL;;327;340;667
7840;VOLTAGO AGORDINO;BL;;392;437;829
7841;VOLTERRA;PI;;4631;5065;9696
7842;VOLTIDO;CR;;168;160;328
7843;VOLTURARA APPULA;FG;;183;208;391
7844;VOLTURARA IRPINA;AV;;1464;1557;3021
7845;VOLTURINO;FG;;741;813;1554
7846;VOLVERA;TO;;4224;4297;8521
7847;VOTTIGNASCO;CN;;252;245;497
7848;ZACCANOPOLI;VV;;332;341;673
7849;ZAFFERANA ETNEA;CT;;4715;4668;9383
7850;ZAGARISE;CZ;;723;752;1475
7851;ZAGAROLO;RM;;9272;9072;18344
7852;ZAMBRONE;VV;;876;908;1784
7853;ZANDOBBIO;BG;;1360;1306;2666
7854;ZANE';VI;;3233;3354;6587
7855;ZANICA;BG;;4340;4331;8671
7856;ZAPPONETA;FG;;1695;1589;3284
7857;ZAVATTARELLO;PV;;456;469;925
7858;ZECCONE;PV;;834;862;1696
7859;ZEDDIANI;OR;;570;561;1131
7860;ZELBIO;CO;;100;82;182
7861;ZELO BUON PERSICO;LO;;3621;3797;7418
7862;ZEME;PV;;517;479;996
7863;ZENEVREDO;PV;;239;237;476
7864;ZENSON DI PIAVE;TV;;856;885;1741
7865;ZERBA;PC;;40;30;70
7866;ZERBO;PV;;190;206;396
7867;ZERBOLO';PV;;830;815;1645
7868;ZERFALIU;OR;;493;524;1017
7869;ZERI;MS;;464;506;970
7870;ZERMEGHEDO;VI;;702;645;1347
7871;ZERO BRANCO;TV;;5724;5764;11488
7872;ZEVIO;VR;;7734;7758;15492
7873;ZIANO DI FIEMME;TN;;856;902;1758
7874;ZIANO PIACENTINO;PC;;1262;1179;2441
7875;ZIBIDO SAN GIACOMO;MI;;3427;3410;6837
7876;ZIGNAGO;SP;;242;233;475
7877;ZIMELLA;VR;;2465;2359;4824
7878;ZIMONE;BI;;199;193;392
7879;ZINASCO;PV;;1500;1575;3075
7880;ZOAGLI;GE;;1134;1172;2306
7881;ZOCCA;MO;;2309;2263;4572
7882;ZOGNO;BG;;4209;4376;8585
7883;ZOLA PREDOSA;BO;;9324;9793;19117
7884;ZOLLINO;LE;;900;992;1892
7885;ZONE;BS;;524;515;1039
7886;ZOPPE' DI CADORE;BL;;94;97;191
7887;ZOPPOLA;PN;;4165;4181;8346
7888;ZOVENCEDO;VI;;426;372;798
7889;ZUBIENA;BI;;558;559;1117
7890;ZUCCARELLO;SV;;141;145;286
7891;ZUGLIANO;VI;;3279;3504;6783
7892;ZUGLIO;UD;;272;280;552
7893;ZUMAGLIA;BI;;473;510;983
7894;ZUMPANO;CS;;1315;1318;2633
7895;ZUNGOLI;AV;;471;505;976
7896;ZUNGRI;VV;;949;933;1882
